2018_매출액,2019_매출액,2020_매출액,2021_매출액,2018_유동자산,2019_유동자산,2020_유동자산,2021_유동자산,2018_유동부채,2019_유동부채,2020_유동부채,2021_유동부채,2018_총자산,2019_총자산,2020_총자산,2021_총자산,2018_총부채,2019_총부채,2020_총부채,2021_총부채,2017_roa,2018_roa,2019_roa,2020_roa,2021_roa,2018_이익잉여금,2019_이익잉여금,2020_이익잉여금,2021_이익잉여금,2018_자기자본,2019_자기자본,2020_자기자본,2021_자기자본,종목,번호,category
10455,10003,8720,10267,15121,5011,3547,2739,16091,7968,7089,5252,25751,18033,15882,13550,20833,14559,13002,9925,0.9,1.5,1.9,-0.2,5.2,1572,1988,1806,2479,4918,3474,2880,3625,AJ네트웍스,095570,1026
186701,223525,242457,262892,55224,79430,74699,77256,66804,82022,70827,79159,194970,262806,256119,268558,121888,167992,154455,160490,2.5,5.1,0.8,3.0,3.4,36943,37864,44068,49402,73082,94814,101664,108068,CJ제일제당,097950,1027
11780,11122,10579,10801,3339,3323,3760,4353,3545,5829,4224,2682,19370,17907,14727,14881,8843,8394,8416,8357,1.6,2.1,-5.1,-19.2,1.8,6690,5676,2474,2686,10527,9513,6311,6524,LG헬로비전,037560,1026
1226,1350,1316,1590,1885,1948,1899,1891,208,191,190,292,3044,3143,3237,3537,297,281,282,415,4.8,4.2,5.4,3.7,6.2,1699,1797,1872,2007,2747,2862,2955,3122,CS홀딩스,000590,1021
2371,2385,2724,3269,837,839,886,845,605,592,1179,506,2884,3632,4725,6020,1508,1522,1588,1642,-0.5,-1.6,1.4,1.5,4.0,436,481,540,772,1376,2110,3137,4378,DB,012030,1026
6693,8074,9359,12147,3834,4263,4592,8152,1568,2197,2617,3353,10665,10889,11786,15499,5081,4442,3840,4439,11.1,8.4,9.7,14.6,23.2,2869,3756,5254,8320,5584,6447,7946,11060,DB하이텍,000990,1027
5454,5470,4966,5513,3073,3198,3604,3848,2144,2237,2406,3118,7162,7453,7764,8320,2680,2838,3128,3564,2.8,1.6,1.8,0.8,-0.4,4155,4218,4220,4168,4482,4615,4636,4756,DRB동일,004840,1027
2360,2363,2310,2724,1189,1237,1348,1857,728,777,814,1156,2250,2404,2529,3026,776,851,900,1246,5.2,3.5,3.8,3.6,4.5,1244,1319,1399,1513,1474,1553,1629,1780,DSR,155660,1027
46302,46083,39276,51523,14464,14121,13581,16290,13625,11029,16378,13117,35654,35950,37314,39993,22495,23917,24880,26259,2.5,2.3,-1.5,1.5,3.6,11898,11341,11827,13006,13159,12033,12434,13734,E1,017940,1016
6683,9103,207,7271,2911,4001,5222,6832,998,1614,2428,5736,4958,6844,8178,29123,1010,2007,2661,5980,21.2,24.4,18.6,11.4,108.2,3839,4796,5501,24625,3948,4837,5517,23143,F&F홀딩스,007700,1021
4803,4908,1845,851,4556,4571,3472,2370,1686,2118,1288,1011,7658,9094,7084,5313,2037,3243,2221,1478,11.0,10.4,8.6,-8.0,-18.3,5099,5330,4342,3314,5621,5851,4863,3835,GKL,114090,1026
177444,177861,154442,202401,32851,31175,34368,53889,45688,47896,39978,55018,226310,247341,244768,311913,121060,137183,137203,169883,5.2,4.6,2.8,-0.8,5.8,99059,102829,98348,111313,105250,110158,107565,142030,GS,078930,1021
131394,104166,101229,90366,78282,73289,72519,81951,63597,58009,57289,67693,120333,131712,137707,151837,84086,90282,94586,103110,-1.2,4.6,3.6,2.5,3.0,24871,28274,30761,34057,36247,41430,43121,48727,GS건설,006360,1018
40585,38894,28150,38490,8009,7210,5608,10387,7495,6726,5403,9266,13360,12052,9568,14427,9329,8253,6578,11002,1.7,1.5,-1.3,-7.6,1.8,840,633,-170,71,4031,3799,2990,3425,GS글로벌,001250,1016
86916,90069,88623,97657,7095,8004,9233,11839,17204,17771,16822,20552,50989,70497,71778,94560,26405,44826,45106,50416,2.4,2.6,2.4,2.2,9.6,18598,19686,20833,28531,24584,25671,26672,44144,GS리테일,007070,1016
1094,993,810,600,784,960,957,1201,224,190,167,1185,2313,1658,1463,2386,267,290,277,1204,1.0,-4.1,-33.4,-11.7,-5.3,419,-245,-426,-522,2046,1368,1186,1182,IHQ,003560,1026
1552,1702,1835,1698,579,599,565,644,731,669,693,839,2009,2014,2144,2195,916,788,819,880,8.6,7.9,10.9,8.3,6.0,413,547,646,703,1093,1226,1325,1315,JW생명과학,234080,1027
5372,5113,5473,6066,3739,3351,2993,3665,2284,2780,2347,2827,5938,5732,5491,6331,3337,3431,3416,4445,-0.1,1.3,-4.3,-2.7,-0.2,1217,868,651,586,2601,2301,2075,1886,JW중외제약,001060,1027
7254,7264,7815,7889,6435,5809,4613,4450,5013,6513,6081,4951,12756,12343,11136,10658,8746,8918,7892,7610,4.5,2.8,-2.7,0.3,0.4,604,64,84,24,4010,3425,3244,3048,JW홀딩스,096760,1021
30810,27196,50836,58749,26456,32303,33722,36681,14222,31876,30141,27000,89654,93822,123476,128789,32241,49290,71016,75028,0.5,-0.3,-2.4,5.2,-0.4,54447,51321,56667,46784,57413,44532,52460,53761,KCC,002380,1027
4004,4462,4887,6947,861,991,1183,1582,1022,1325,1301,1354,3760,4243,4414,5323,1864,2270,2322,3033,2.5,2.0,2.1,3.2,4.4,1299,1341,1459,1641,1896,1973,2092,2290,KCTC,009070,1019
5347,6989,6804,7508,3418,4381,3635,4989,2757,3817,3411,4652,6708,8161,7761,9066,3841,5218,5461,6466,1.9,3.2,1.9,-9.9,1.2,1135,1186,792,806,2867,2943,2300,2600,KC그린홀딩스,009440,1021
1820,3006,3279,3550,1420,2409,1891,3142,1191,2155,1850,2653,2195,3320,2819,3851,1417,2558,2696,3351,4.1,1.1,0.2,-20.8,3.6,415,417,-226,-105,778,762,123,500,KC코트렐,119650,1027
2174,2017,2010,2675,1542,1455,1817,2005,855,949,863,978,3512,3342,3683,4006,1258,1203,1996,1214,0.4,0.5,-5.8,-12.8,2.7,12,-186,-622,-534,2254,2139,1687,2792,KEC,092220,1027
764,458,204,409,398,151,184,219,601,294,225,171,649,271,321,330,640,306,246,234,-25.5,-32.3,-35.2,-21.3,-4.9,-852,-1016,-1079,-1096,9,-35,75,96,컨버즈,109070,1027
12828,20684,36864,49315,6642,14417,13218,18855,7231,15878,14342,18159,15086,41515,43235,48849,9044,28000,28159,30974,0.7,1.9,7.8,3.7,6.1,1698,2609,3043,3746,6042,13515,15076,17875,KG케미칼,001390,1027
12886,11830,10646,15808,11179,10948,11363,12584,2419,1931,1967,2306,15452,15573,15646,16881,2661,2298,2298,2674,-0.5,2.4,4.1,2.3,11.0,5309,5695,5968,6977,12791,13275,13348,14207,KISCO홀딩스,001940,1027
7667,7657,7467,10208,3193,2747,3542,4533,817,496,937,1885,5353,5379,6370,7771,916,556,1034,1991,5.0,2.2,8.0,11.0,7.0,3872,4241,4757,5116,4437,4823,5336,5780,KPX케미칼,025000,1027
10224,9727,9532,12387,5804,4968,6527,7756,2360,1850,2526,3424,14166,14490,16987,18149,2907,2677,3619,4454,4.3,1.0,5.3,12.3,4.7,3654,3890,5192,5523,11259,11813,13368,13695,KPX홀딩스,092230,1027
366,1326,1178,1335,870,527,610,697,706,864,841,955,1549,1441,1559,1684,850,1089,1060,1182,-24.5,-18.6,-27.5,-7.7,-7.4,-525,-937,-1020,-287,699,352,499,502,KR모터스,000040,1027
2025,2312,2262,3240,447,642,725,681,1195,1682,2401,3816,9045,9572,10695,14462,6532,6762,8007,11034,3.3,2.3,2.5,1.3,4.5,2310,2525,2603,3088,2513,2810,2688,3428,KSS해운,044450,1019
234601,243421,239167,248980,118943,118972,111542,118584,93877,101481,91925,100724,321888,345401,336625,371593,174576,193566,181111,205922,1.9,2.5,2.0,2.1,4.1,113289,116338,121554,132874,147312,151835,155514,165671,KT,030200,1020
44715,49632,50553,52284,64134,64172,67504,62559,16407,16001,19915,20639,101979,107524,114684,116373,20297,20129,23768,24284,12.3,8.9,9.9,10.6,8.4,71015,75147,80801,85504,81682,87395,90916,92089,KT&G,033780,1027
10161,9449,9317,9657,2955,2710,2899,3030,1786,1630,1757,1896,3503,3781,3849,4168,1886,2140,2152,2342,2.2,3.3,2.1,3.0,4.8,1177,1199,1278,1410,1617,1641,1697,1826,KTcs,058850,1026
17067,18517,16105,17931,9701,9620,10829,11644,2986,7100,7208,6132,16518,24171,24794,25411,4684,10256,10650,10428,4.4,5.0,3.4,1.2,5.4,8362,8861,8893,9948,11834,13915,14144,14983,LF,093050,1027
77434,65345,51991,68590,46131,39391,58959,55479,30395,22448,21333,28193,228359,224346,242823,256698,46714,34136,34210,37296,11.8,8.5,4.9,6.6,10.8,150486,156993,167824,188914,181645,190210,208613,219402,LG,003550,1021
243366,234756,242616,298780,88001,102483,110995,131871,99545,109850,110069,139948,331757,355746,350660,381545,182895,230863,223346,233920,7.2,-0.6,-8.4,-0.2,3.6,102400,75033,75188,85415,148862,124883,127314,147625,LG디스플레이,034220,1027
99882,105309,112826,166865,25584,24840,31628,43765,21674,21263,25183,34309,50381,48760,53959,67469,34885,33274,36376,43626,1.7,-0.7,-0.3,7.0,8.9,8801,8972,11870,15222,15496,15486,17583,23843,LX인터내셔널,001120,1016
67475,76854,78445,80915,16912,21631,19828,24729,13589,17712,14797,15258,52759,64937,68014,75552,16819,22566,19522,20574,13.3,13.8,13.4,12.2,12.0,35634,41749,48054,54840,35940,42371,48492,54978,LG생활건강,051900,1027
117257,123820,134176,138511,42472,48055,49509,51644,38330,46489,43283,50737,139399,179411,183502,193705,70866,105914,106990,114120,4.6,3.7,2.8,2.6,3.8,34472,36736,39686,43641,68533,73497,76512,79585,LG유플러스,032640,1020
79821,79754,95418,149456,22333,25309,31618,41134,15844,20462,22842,33103,57561,57708,60386,77414,36378,35662,36109,44271,3.4,2.8,1.8,4.0,12.9,9067,9893,12215,20481,21183,22046,24277,33143,LG이노텍,011070,1027
613417,623062,580579,747216,193629,197535,232394,274878,171350,176579,202075,236199,443284,448599,482042,534815,280215,284347,306621,333834,4.7,3.4,0.4,4.4,2.8,120754,118573,136528,144336,163069,164252,175421,200981,LG전자,066570,1027
32665,31868,30380,34720,10809,10224,10727,11487,7368,9745,9715,12201,25097,25656,23854,25474,15930,16496,15482,16840,2.8,-2.1,0.5,-3.2,0.5,2774,2836,2061,2180,9167,9160,8372,8634,LX하우시스,108670,1027
281830,273531,300589,426547,120885,118697,163197,204138,72735,89415,126242,150621,289441,340244,413889,511353,116220,166406,225985,279253,8.9,5.6,1.2,1.8,8.6,149943,147987,151753,180919,173221,173838,187904,232100,LG화학,051910,1027
14775,14527,16003,18222,14198,13809,15457,14859,13059,12375,13804,14811,23221,23175,25956,25768,16720,16835,19231,18135,-0.5,0.2,0.1,2.4,4.1,3270,3107,3580,4439,6501,6340,6725,7633,LIG넥스원,079550,1027
100927,101518,104443,130891,59775,60164,66922,74855,39566,39734,43405,51739,104903,107635,116605,126259,61307,64922,72120,79157,3.7,4.8,0.9,1.7,2.9,28318,28086,29003,31575,43596,42713,44485,47102,LS,006260,1021
4459,4028,3349,3905,2597,2677,2779,2801,2105,1701,5938,1714,12736,11736,12284,13094,6355,6543,7352,7557,1.6,1.3,-5.7,-2.1,4.7,2682,1987,1740,2345,6381,5193,4932,5537,LS네트웍스,000680,1016
24850,23468,24027,26683,15361,16669,16498,18877,7002,7538,6442,8453,24058,25381,25404,27967,11084,11755,11269,13233,4.7,5.7,4.2,3.4,3.2,11833,12464,12981,13569,12974,13626,14135,14734,LS ELECTRIC,010120,1027
4413,5203,5796,7506,2402,2447,3062,3813,1895,1917,2482,3076,3496,3597,4166,4953,2060,1984,2677,3229,5.1,3.4,4.8,2.1,3.5,281,392,410,496,1436,1613,1489,1724,LS전선아시아,229640,1021
728,809,946,1021,296,328,377,521,1411,2824,1461,2973,4402,4515,4497,4515,3486,3721,3693,3668,1.5,-2.6,-1.7,0.8,1.9,642,611,655,684,916,794,804,847,MH에탄올,023150,1027
55869,43562,53041,68176,53856,56437,105447,55279,26197,37731,79118,39233,98812,122995,170142,336910,39321,57956,87591,96636,10.7,7.0,3.6,5.8,65.0,52292,57121,66548,230804,59491,65039,82551,240274,NAVER,035420,1026
12646,14886,16412,19237,10063,10587,10869,13599,5625,5328,5588,7197,24947,25003,25509,30272,6746,6716,7068,9286,0.4,4.5,0.9,1.1,4.7,3862,4002,4341,6538,18201,18287,18441,20986,NHN,181710,1026
14702,18738,20555,24499,12084,15015,15453,16971,9176,11317,12328,15107,21730,25648,27304,30838,11330,13412,14808,17633,5.9,5.1,3.3,2.0,3.5,4080,4274,4352,4868,10400,12236,12496,13205,NICE,034310,1026
4149,4545,4313,4869,1734,1664,1656,1576,1225,995,983,1345,3928,4038,4106,5000,1318,1196,1152,1768,3.0,3.1,3.6,4.6,5.8,2216,2349,2496,2715,2610,2842,2954,3232,NPC,004250,1027
31121,26051,20025,32440,20187,21607,20360,33390,10929,8458,8597,12365,56596,48112,44372,57041,21670,21255,20515,25803,3.8,1.8,-15.4,-5.4,12.9,25288,17041,14548,20927,34926,26857,23857,31238,OCI,010060,1027
649778,643668,577928,763323,336510,348424,358308,466216,189380,163237,168550,210836,782483,790587,790870,914716,314887,312640,314124,366667,3.8,2.4,2.5,2.3,8.4,442160,450801,461115,515329,467596,477947,476746,548049,POSCO홀딩스,005490,1027
1395,2133,2374,1711,1555,2050,2037,1997,316,675,809,662,2810,3339,3354,3321,497,889,996,873,1.4,0.6,5.0,2.9,3.8,1873,2024,2037,2111,2313,2450,2358,2448,SNT에너지,100840,1027
9189,9763,9407,9417,6801,6259,6439,6663,2815,2411,2741,2347,11965,10389,10929,11498,3717,3029,3322,2922,4.8,4.7,0.3,5.1,7.1,6130,5990,6262,6950,8248,7360,7607,8576,SNT모티브,064960,1027
3963,3751,3018,3360,4137,4114,3841,4483,1180,1063,1213,1243,8457,8414,8334,8796,2382,2243,2359,2267,-3.6,2.4,2.0,1.0,6.9,5686,5782,5759,6282,6075,6171,5975,6529,SNT중공업,003570,1027
14013,15121,14358,14041,11680,12665,12420,13275,3816,4056,4614,4125,21138,22367,22705,23723,6106,6107,6530,5922,1.2,3.5,5.7,3.5,6.5,4721,5280,5556,6267,15032,16260,16175,17801,SNT홀딩스,036530,1021
254633,243942,168297,274639,58545,56289,49965,83774,57890,57487,65651,85050,159550,163334,156905,186932,94858,98368,100080,117052,8.6,1.7,0.4,-5.0,8.0,48231,48482,40357,53337,64692,64966,56825,69880,S-Oil,010950,1027
9140,8177,8603,10790,4935,7170,6582,9127,2102,3930,2414,5155,9576,12478,11691,14622,3892,6006,5980,7406,1.6,0.6,1.9,-4.8,11.0,4175,4309,3607,5023,5684,6472,5711,7216,SBS,034120,1026
3202,2461,1678,1357,1996,1452,1393,1245,957,739,683,604,3344,2877,2672,3084,1375,828,710,641,-2.1,2.0,3.1,-3.7,16.3,584,680,574,1044,1969,2049,1962,2443,SG세계물산,004060,1016
1345,930,851,578,525,487,480,290,461,575,367,131,1996,2041,1989,1870,726,740,724,640,0.2,1.6,0.4,-1.1,-2.9,620,623,601,552,1270,1301,1265,1230,SG글로벌,001380,1027
1836,1409,936,1398,858,836,724,783,67,75,74,131,1224,1234,1174,1196,170,244,273,279,7.9,1.6,-2.5,-5.8,0.5,424,364,298,312,1054,990,901,917,SH에너지화학,002360,1027
3062,4301,3659,6130,3107,2892,3532,5422,2285,2195,2491,3314,6818,6791,7373,9032,2467,2380,2733,3566,3.2,13.0,1.4,4.8,11.1,2741,2800,3105,3978,4351,4411,4640,5466,SIMPAC,009160,1027
1553,1577,1387,1457,1315,1440,1472,1554,277,327,325,369,2001,2204,2249,2450,336,454,513,555,2.8,1.8,3.6,1.9,3.2,1148,1198,1210,1287,1665,1750,1736,1895,SJM,123700,1027
1607,1608,1416,1497,1775,1868,1751,1903,365,402,394,464,2895,3089,3083,3329,456,561,604,661,6.8,2.1,3.1,1.6,2.8,1233,1260,1268,1303,2439,2528,2479,2668,SJM홀딩스,025530,1016
1001616,978115,808188,983250,371284,400154,380523,491932,300078,356271,372127,449749,1194570,1326114,1376679,1653809,685691,804354,858080,998157,4.8,5.4,1.3,-0.1,3.8,122173,125566,124967,140656,508879,521760,518599,655652,SK,034730,1021
27678,23611,24659,33961,9101,9927,12473,18200,10815,10432,17339,17200,38331,39730,54064,61801,21383,22466,34913,38978,3.8,3.8,1.7,1.6,5.9,13254,13500,13639,15438,16948,17264,19151,22823,SKC,011790,1027
68592,49311,44123,64945,16098,17138,20405,24058,15006,15704,12716,14420,37556,40824,44989,51215,21128,24216,26002,30042,3.6,1.4,3.9,6.2,5.2,12215,14567,16909,19011,16428,16608,18987,21173,SK가스,018670,1016
126458,130542,106259,110181,32532,39657,26387,30472,37397,45220,37233,38976,77690,101388,87735,94109,54572,78335,65282,70219,0.4,0.1,-1.4,0.4,1.1,9791,8127,8190,8973,23118,23053,22453,23890,SK네트웍스,001740,1016
5628,4547,6998,7910,9143,8182,10058,11797,7327,5674,7053,4656,14901,13969,17124,19834,11423,10355,11810,13442,6.6,4.3,3.1,4.3,7.2,1600,1723,2140,3281,3478,3614,5314,6392,SK디앤디,210980,1026
542165,493069,345499,468429,166347,173536,132951,214817,88666,104572,110148,145124,358534,395345,384981,495574,166791,213213,230397,299242,6.4,4.9,0.2,-5.5,1.1,129285,121752,98913,102112,191743,182132,154584,196332,SK이노베이션,096770,1027
69392,50211,45195,66143,17724,20149,24566,28016,16972,16847,14545,19775,48056,50001,56216,68819,24870,26769,30053,38126,13.8,2.0,5.1,6.7,4.4,18523,20787,23266,25124,23186,23232,26163,30693,SK디스커버리,006120,1021
168740,177407,160877,167486,79588,80885,87751,63527,68476,78517,81780,69604,423691,452024,479070,309113,200199,223854,235107,185761,8.2,8.3,2.0,3.2,6.1,221445,222287,229819,224373,223492,228170,243963,123352,SK텔레콤,017670,1020
404451,269907,319004,429978,198941,144576,165710,268705,130319,79620,90724,147694,636583,652484,711739,963865,168060,173125,192648,341954,27.4,28.5,3.1,7.0,11.5,420336,429234,469957,557841,468523,479359,519091,621911,SK하이닉스,000660,1027
22202,24992,25427,29467,3402,3701,3643,4451,4077,4539,5678,5772,7523,11963,11819,12230,4383,8736,8789,8880,5.4,5.7,2.1,-1.0,3.4,2960,3047,2849,3168,3140,3227,3030,3350,SPC삼립,005610,1027
15030,14637,9756,9255,4229,3864,3199,3662,4636,4398,4583,4484,5541,5601,6508,6761,4900,5038,5432,5536,50.1,1.5,-6.0,-1.6,-3.5,81,-256,-364,-519,641,563,1076,1225,STX,011810,1016
5773,6106,5867,4935,4938,4390,4387,4271,3499,3553,4806,4908,8641,8284,8093,8375,6429,5909,5428,5535,-0.8,3.3,2.4,2.5,0.1,-4744,-4587,-3966,-3960,2212,2375,2665,2840,STX엔진,077970,1027
2148,2540,2480,1639,3211,2213,1525,1824,2822,1985,2585,2449,5672,4475,4674,4304,4008,3175,2934,2764,92.3,-16.4,-7.1,0.2,-1.7,-4067,-4430,-56,-80,1664,1300,1740,1540,STX중공업,071970,1027
4132,4372,4318,5367,1522,1490,1369,2020,932,1660,1338,1387,3048,3142,3068,3670,1925,1974,1856,2118,0.5,3.3,1.6,-0.5,8.5,713,742,767,1005,1123,1168,1212,1552,TCC스틸,002710,1027
1119,1155,1025,1176,759,771,699,674,82,136,115,136,1278,1351,1307,1353,106,166,139,151,0.1,0.8,0.8,-0.8,0.9,884,892,873,885,1172,1185,1168,1202,WISCOM,024070,1027
936,1136,1071,1543,602,690,699,1109,228,338,424,580,1468,1567,1510,2231,313,449,468,774,-7.7,-1.0,-2.8,-4.9,12.1,-116,-148,-211,9,1155,1118,1042,1457,YG PLUS,037270,1026
8407,8303,8574,10704,2778,2648,2858,4019,1475,1681,1923,2465,5265,5126,5425,6590,2661,2558,2789,3909,0.3,0.0,1.1,1.8,1.0,2161,2183,2263,2293,2604,2568,2636,2681,가온전선,000500,1027
3070,3325,3408,5910,1879,1788,2011,2969,604,599,686,1344,6579,6723,7122,9040,1083,1111,1297,2421,4.1,6.3,2.6,3.6,5.9,4401,4505,4710,5204,5496,5612,5825,6619,강남제비스코,000860,1027
14381,15201,4786,7884,17590,18782,14982,16570,6360,6513,3300,5068,42312,44381,36416,38273,6445,7204,3946,5745,10.7,7.1,7.7,-6.8,-0.3,35245,36555,31848,31906,35867,37177,32470,32528,강원랜드,035250,1026
2127,2275,2483,2703,1700,1850,1925,2065,1283,1226,1340,1231,3573,3709,3715,3888,1558,1690,1602,1520,3.1,1.4,1.1,3.6,4.2,1332,1334,1421,1503,2015,2019,2113,2368,경농,002100,1027
7267,7743,8734,11029,2870,2743,3604,4756,2751,2703,3380,4347,5836,6098,7347,9339,3035,3088,3865,4835,5.8,4.6,4.7,6.2,9.7,2465,2677,3029,3786,2801,3010,3482,4504,경동나비엔,009450,1027
2286,2717,3105,2985,1885,2365,2371,2323,784,847,745,611,6001,6055,5893,5777,1922,1909,1585,1379,6.0,5.1,1.5,2.8,2.4,5543,5810,5986,6076,4079,4146,4308,4398,경동인베스트,012320,1021
3514,3439,3292,3834,1207,2649,1173,1255,1632,1924,2856,2307,13018,13707,12649,12708,5930,6292,5230,5187,2.0,1.6,3.3,1.0,1.8,7032,7422,7519,7710,7088,7415,7419,7521,경방,000050,1016
3311,3588,3293,4033,2348,2519,2632,3256,1569,1926,2163,2692,4130,4721,5051,5795,1892,2346,2767,3276,1.4,3.6,3.7,-1.6,5.0,1476,1593,1479,1700,2238,2375,2284,2519,경인양행,012610,1027
185,133,208,274,438,449,455,496,22,19,25,50,574,569,578,659,28,24,38,63,-4.8,-1.2,0.4,2.4,6.0,313,308,315,348,546,545,540,596,경인전자,009140,1027
22927,22757,22000,25618,10784,12772,13519,15981,10054,11532,10261,10922,17262,20046,20703,23271,12864,15019,14643,15727,3.7,5.7,4.0,4.7,7.1,3313,3931,4873,6356,4398,5027,6060,7544,계룡건설,013580,1018
3651,3750,3797,3923,1351,1444,1632,1518,544,659,982,919,2726,2799,2942,2851,852,954,1085,1018,3.7,3.6,0.1,3.3,-2.1,1295,1262,1273,1219,1874,1845,1857,1833,계양전기,012200,1027
1584,1925,1905,2135,1161,1094,963,990,1035,952,1005,1179,2136,2065,2166,2386,1212,1107,1139,1318,2.9,1.9,2.3,3.2,2.0,654,689,751,788,924,958,1027,1068,고려산업,002140,1027
68833,66948,75819,99768,39659,45979,49129,56890,5384,7043,11184,17705,72259,78406,84996,99640,8514,10022,14126,22298,9.4,7.5,8.5,7.0,8.8,61381,65917,69397,75184,63745,68384,70870,77342,고려아연,010130,1027
15772,16397,13974,16914,9494,9162,8578,10778,6901,6405,5873,6012,23875,23466,22457,24743,9304,8758,7828,8362,0.9,0.1,-0.2,0.1,5.7,13933,13408,13443,14872,14571,14708,14629,16381,고려제강,002240,1027
11802,12383,12438,13382,4591,5260,5845,5878,2714,3084,3022,3255,7321,7928,8306,8838,3012,3453,3285,3566,3.3,3.0,3.0,5.6,3.0,3495,3693,4118,4332,4309,4475,5021,5272,광동제약,009290,1027
1126,1319,1235,1371,700,871,1030,1126,363,451,499,491,1518,1567,1659,1699,531,513,561,548,-1.4,1.8,4.6,2.8,3.5,462,539,586,641,987,1054,1098,1151,광명전기,017040,1027
1769,1662,1502,1738,1308,1275,1183,1210,232,226,247,218,2621,2603,2434,2390,377,379,421,283,1.2,2.5,1.3,-6.5,4.3,524,523,328,444,2244,2224,2013,2107,광전자,017900,1027
12806,11214,11327,15771,4512,4387,4536,8046,2696,2309,2475,4820,8544,9054,9306,14164,3548,3709,3783,6014,5.7,5.7,4.0,3.4,13.4,4295,4670,4880,6392,4996,5345,5523,8150,국도화학,007690,1027
2196,2231,2534,2270,838,895,1330,1031,632,429,843,526,1230,1333,1807,1685,750,688,969,661,-7.8,2.6,-3.1,6.8,-4.6,86,60,159,60,480,645,838,1024,국동,005320,1016
716,891,1099,969,118,705,506,595,281,753,534,612,482,1154,908,1023,348,868,600,705,-3.7,-6.6,-8.2,-19.9,-18.3,-72,-137,-292,-467,134,286,308,318,국보,001140,1019
1077,1111,1304,1197,546,611,499,482,482,593,554,545,1262,1346,1456,1398,575,736,751,712,0.8,1.7,-3.7,1.6,-1.1,79,5,31,11,687,610,705,686,국제약품,002720,1027
8309,7956,6229,9648,1268,1185,1113,1459,689,807,825,1122,2801,2899,2927,3219,1202,1206,1199,1399,6.6,5.9,5.0,2.5,3.6,1460,1548,1569,1646,1599,1693,1728,1820,극동유화,014530,1027
5679,5497,5019,5705,3629,3886,3068,3553,4223,4442,3523,4053,8528,8340,7792,8687,4986,4881,4259,4820,3.6,1.9,-0.6,0.3,2.7,2396,2276,2281,2479,3542,3459,3533,3867,금강공업,014280,1027
2014,2193,2286,565,1056,991,927,935,565,814,793,730,2602,3340,3379,3396,966,1765,1760,1803,4.1,4.1,-1.2,1.5,-1.4,913,866,895,878,1636,1575,1619,1593,금비,008870,1027
2054,1727,1762,2177,1294,1303,1264,1951,1146,1402,804,1278,2048,2242,2199,3148,1253,1559,1401,1974,9.9,10.1,-5.1,-1.8,5.0,403,262,224,355,795,683,798,1174,금양,001570,1027
13767,15977,18296,20651,6189,10143,7816,9891,6397,7631,8314,8699,11822,13374,13772,17360,8259,9609,9870,10832,7.5,0.0,0.9,2.0,9.5,2086,2018,2044,3341,3563,3765,3902,6528,금호건설,002990,1018
55849,49615,48095,84618,13487,12614,17055,34452,17589,12756,12102,23603,46167,45380,50273,81157,22686,19085,18780,30328,4.8,10.9,6.4,12.2,29.9,19246,21867,27274,45651,23481,26295,31493,50829,금호석유,011780,1027
2093,2511,2196,2340,1555,2049,2049,1918,867,1325,1201,1047,2384,3221,3443,4588,1135,1494,1212,1080,3.2,4.0,0.0,-3.0,-4.4,874,885,792,602,1249,1727,2231,3508,금호에이치티,214330,1027
636,592,450,416,613,355,457,652,1112,492,594,630,1703,731,678,839,1356,562,635,655,-4.6,-7.2,-27.3,-34.6,-13.0,-302,-493,-280,-181,347,169,43,184,금호전기,001210,1027
25587,23692,21707,26012,13458,10867,11704,15669,12209,9377,9504,15005,42214,39295,38462,43422,28797,26368,26786,30606,-2.3,-4.4,-1.1,-2.1,-1.8,-3138,-3737,-4822,-5633,13417,12927,11676,12816,금호타이어,073240,1027
1190,1247,1285,970,1294,1378,1444,1496,101,133,145,130,2458,2517,2596,2624,121,144,155,142,4.1,6.2,3.5,3.8,3.6,1960,2015,2059,2087,2337,2373,2441,2482,기신정기,092440,1027
541698,581460,591681,698624,197118,215554,260934,292055,148347,172766,210976,215626,517866,553448,604904,668500,245431,263667,305988,319374,1.9,2.2,3.4,2.6,7.5,247117,260562,271734,316829,272435,289781,298916,349126,기아,000270,1027
6263,5942,5916,5787,1663,1154,1192,1323,3281,2464,1812,1640,5994,5383,5631,5987,4247,3758,3462,3692,-4.1,-5.7,-2.1,7.0,1.4,-407,-533,435,501,1747,1625,2169,2295,깨끗한나라,004540,1027
510,782,1271,1412,1413,3471,4345,4843,998,1087,851,1108,3952,6472,8343,8241,1996,1296,1443,1197,1.4,-9.7,3.5,-4.4,-1.5,-283,-390,-854,-1053,1956,5176,6900,7044,에이프로젠 MED,007460,1027
1572,2362,2380,3567,990,1419,1275,2058,938,1403,1309,1712,1489,2026,2040,2740,998,1497,1377,1862,1.0,3.6,2.2,6.8,9.1,157,196,328,545,491,529,663,878,남광토건,001260,1018
3478,3248,2685,2303,1290,1203,1124,1165,909,730,637,693,3030,2955,2952,3552,1343,1164,1056,1193,7.7,8.6,4.8,3.6,12.8,1086,1226,1332,1771,1687,1791,1896,2359,남선알미늄,008350,1027
833,730,925,1023,781,814,850,1265,1040,880,970,1197,2051,2048,2330,2888,1223,1189,1265,1702,0.7,-1.8,-1.1,-4.6,2.7,504,477,622,688,828,859,1065,1186,남성,004270,1016
10797,10308,9489,9561,6287,5469,5078,4800,1487,1007,974,969,10527,10564,10011,9374,1638,1441,1279,1244,0.5,0.2,2.8,-5.1,-6.1,9059,9293,8903,8300,8889,9123,8732,8130,남양유업,003920,1027
2114,1967,1833,1879,792,703,1034,886,324,234,342,269,1411,1333,1890,1982,365,320,988,949,-1.1,-4.0,-1.8,-32.4,-1.7,769,736,206,174,1046,1013,902,1033,비비안,002070,1027
12427,11872,10098,14519,3410,3738,3831,5033,1084,1267,1188,2321,5479,5811,5894,7191,1232,1472,1365,2475,4.9,1.5,2.8,4.3,3.3,3375,3467,3652,3795,4247,4339,4529,4716,남해화학,025860,1027
13600,22913,19685,24039,11105,12054,13440,16455,7177,6857,8491,11529,38251,40980,42392,45723,19423,20577,21979,24555,8.0,3.6,3.3,0.0,0.7,7841,8569,8712,9068,18828,20403,20413,21168,넥센,005720,1027
19840,20223,16981,20794,9835,10886,12003,14760,6350,6184,7668,10417,32423,34361,35411,38234,18141,18781,19941,22235,4.6,3.4,3.6,-0.5,0.1,12914,14103,14007,14215,14282,15580,15470,15999,넥센타이어,002350,1027
20213,21787,24848,25069,25906,25601,18207,19626,5870,6646,16335,30562,54330,58061,82234,106638,8815,11577,25728,46561,9.9,4.0,3.0,4.8,2.6,7610,9145,12262,22346,45515,46484,56506,60077,넷마블,251270,1026
6147,6475,6429,7309,2396,2637,3030,3038,1961,1949,2544,2099,6074,6273,6667,6706,2996,3050,3328,3257,5.1,2.1,3.1,2.8,2.2,1938,2075,2202,2290,3078,3223,3339,3449,노루페인트,090350,1027
8360,8843,8480,9552,4491,4528,4849,4951,2725,2714,3359,3083,9871,10074,10511,10555,4256,4399,4731,4720,6.3,0.3,2.0,2.8,1.0,3024,3011,3113,3083,5615,5675,5780,5835,노루홀딩스,000320,1021
13349,13571,15041,15378,8934,9618,11320,10956,3035,4014,5894,5529,17234,19593,21514,24621,5972,7752,8821,9624,3.5,2.0,-0.6,4.3,5.9,7018,6795,7573,8674,11262,11841,12693,14997,녹십자,006280,1027
15487,14936,17193,18406,11446,11237,15358,14249,6618,6763,11028,9259,26286,27739,32412,34968,11755,12673,15677,15861,2.9,0.8,-1.1,6.0,3.8,7578,7453,9063,9452,14531,15066,16735,19107,녹십자홀딩스,005250,1026
22364,23439,26398,26630,10538,10786,10744,10887,5222,5850,5221,5373,25323,26531,27255,28999,6345,7123,6766,6991,3.7,3.4,2.7,5.5,3.5,18425,18780,20007,20831,18978,19408,20489,22008,농심,004370,1027
5432,5367,5836,6415,2132,2208,2082,2292,2316,2477,2290,2407,11948,12165,12481,13286,2989,2944,2746,2897,3.5,4.0,3.0,5.6,3.8,6159,6380,6951,7362,8959,9221,9735,10389,농심홀딩스,072710,1021
22024,29018,47329,60870,142703,205307,344794,386423,102939,131624,199048,222258,193457,247416,386222,463224,169051,220774,353771,417060,2.1,1.4,1.8,2.1,2.2,8897,10586,13158,16672,24406,26642,32451,46164,다우기술,023590,1026
196,267,455,1191,72,223,253,800,20,82,202,649,187,420,482,2901,21,210,210,674,-10.3,0.7,7.5,0.2,2.1,68,92,92,132,166,210,272,2227,키다리스튜디오,020120,1026
7631,7619,6270,6384,2852,2726,2202,2249,1522,1788,1779,1835,8303,9199,8452,8136,2135,3066,2863,2972,4.9,2.3,2.0,-2.1,-5.1,5757,5725,5445,4984,6168,6133,5589,5164,대교,019680,1026
1200,1015,911,818,1347,1826,351,1404,1625,3227,1627,1546,7002,6736,5087,4866,3903,3874,2463,2326,-2.2,-4.2,-2.8,-3.0,-1.2,1925,1725,1539,1515,3099,2862,2624,2540,대구백화점,006370,1016
6548,8344,8958,11792,4478,4737,4664,6882,4308,4815,4971,6917,7727,8274,9387,12606,5552,6085,6104,8747,1.4,0.2,0.3,2.4,3.2,1848,1845,2019,2353,2175,2189,3283,3859,대동,000490,1027
480,450,398,336,736,791,812,845,136,114,140,68,1710,1790,2050,2087,331,320,410,346,0.4,2.1,2.6,1.7,5.1,1037,1080,1071,1149,1379,1470,1640,1741,대동전자,008110,1027
2472,2364,2324,2604,1142,1138,1268,1116,753,683,796,1079,3017,3092,3263,3266,1416,1498,1685,1692,2.2,1.3,0.7,-0.6,0.3,1328,1323,1294,1274,1601,1594,1578,1574,대림B&Co,005750,1027
109845,16604,15661,23854,63666,67397,93278,25127,45300,42714,83677,14609,128337,134452,139019,83230,67835,67085,106905,37927,3.9,5.2,5.4,4.2,7.9,47930,53299,57714,65885,60502,67367,32114,45303,DL,000210,1021
2056,1955,1861,2266,1771,1484,1255,1278,519,454,390,549,3389,3372,3264,3519,624,584,490,748,1.2,-2.1,0.8,-0.3,-0.9,1897,1919,1905,1875,2765,2788,2774,2771,삼일씨엔에스,004440,1027
2013,1836,1566,1552,1178,1026,849,918,891,666,640,818,1993,1795,1597,1658,925,878,832,897,-1.9,-0.6,-6.2,-7.6,0.2,176,30,-126,-81,1068,917,765,761,대림통상,006570,1027
29568,29640,31132,34700,9049,10778,13022,15234,7385,7951,7815,9538,21990,23896,25283,28705,12703,13749,14268,16233,2.3,2.9,4.8,5.2,5.4,6510,7226,8275,9474,9287,10147,11015,12472,대상,001680,1027
33980,35525,37543,42060,10812,12713,15550,18226,8396,9321,9423,12071,26296,28888,30602,36261,15348,16870,17342,21350,2.2,1.7,5.0,5.5,4.3,2390,2975,3790,4215,10948,12018,13260,14911,대상홀딩스,084690,1021
9455,8699,8324,11291,1829,1873,2085,3185,3342,3602,2216,2465,10928,10324,11017,16524,6414,6451,6157,11915,20.1,-0.6,-5.9,4.5,-2.8,3484,2834,3366,2842,4514,3873,4860,4609,대성산업,128820,1016
7710,7749,7432,7704,2129,2107,2030,2327,2173,2299,2776,2477,6539,6972,7021,7425,3519,3907,3877,4251,2.3,2.0,1.9,2.0,1.7,689,738,828,880,3020,3065,3144,3174,대성에너지,117580,1017
9098,9186,8843,9405,3447,3034,3149,3466,3064,3259,3562,2865,11173,11358,11811,12440,5847,5960,5995,6471,2.9,2.1,1.6,4.1,2.0,3978,4017,4416,4536,5326,5398,5816,5969,대성홀딩스,016710,1026
106055,86519,81367,86852,52796,60494,59731,71489,49929,50847,49364,50490,87338,96977,93059,104580,64161,72094,66289,72416,2.8,3.4,2.2,3.0,4.9,-138,1886,5078,9747,23177,24883,26770,32164,대우건설,047040,1018
96444,83587,70302,44866,73500,68711,59532,64811,53568,48075,51627,74645,119185,112761,103208,106232,80783,75212,64518,84056,4.9,2.7,-0.4,0.8,-16.2,6470,5584,6753,-10013,38402,37549,38690,22176,대우조선해양,042660,1027
12313,13657,13553,15114,7342,7578,8363,8480,3825,2949,3678,5140,15922,16709,18375,19337,6279,6548,7206,7767,5.7,2.1,4.3,6.8,5.3,4261,4772,5722,6469,9643,10161,11169,11570,대웅,003090,1021
10314,11134,10554,11530,5157,5263,5284,5249,3674,2621,3268,4607,12078,12457,13669,14152,6000,6097,6717,7128,3.0,-1.3,2.4,1.9,2.2,4229,4454,4528,4711,6078,6360,6952,7024,대웅제약,069620,1027
9954,9602,8612,8622,3522,3219,3296,3468,3796,3720,3638,3425,10858,10480,10179,9830,5150,4607,4458,4060,2.1,2.1,2.0,-0.3,-0.3,4305,4410,4251,4171,5708,5873,5721,5770,대원강업,000430,1027
4295,4013,3673,4750,1473,1426,1420,1949,992,950,935,1416,1915,1896,1920,2406,1101,1092,1066,1529,0.7,0.6,-0.4,1.2,0.6,433,421,441,457,814,804,854,877,대원전선,006340,1027
2867,3178,3085,3542,1067,1215,1173,1804,577,617,560,1021,2754,3275,3352,4296,922,1233,1224,2112,4.7,9.3,8.9,5.2,1.7,1678,1883,2005,2048,1832,2042,2128,2184,대원제약,003220,1027
1146,1331,1088,1133,748,616,620,721,445,399,470,565,1248,1305,1298,1358,516,511,538,648,1.2,0.9,4.6,-1.7,-5.3,295,352,337,264,732,794,760,710,대원화성,024890,1027
11102,12850,14669,16558,3822,5335,5539,6476,5512,7164,7256,9218,8896,11173,11665,13210,7192,8813,9272,11313,0.4,-4.5,1.8,1.9,-0.2,-154,-35,-80,-249,1704,2360,2393,1897,대유에이텍,002880,1027
5034,4573,4529,5120,2455,8486,1991,3197,1989,8712,2874,3405,10000,10891,4731,5944,8631,9282,3522,4555,-0.4,1.9,2.0,-0.7,0.4,-507,-405,-475,-480,1369,1609,1209,1389,대유플러스,000300,1027
9513,8990,9336,12776,3082,3236,3529,4963,2950,3259,3051,3676,5694,5761,6203,8107,3536,3611,3989,5366,2.5,2.2,0.8,1.2,3.7,771,785,844,1101,2158,2150,2214,2741,대창,012800,1027
3205,2773,2645,3544,1586,1621,1716,1970,374,329,346,522,2290,2386,2472,2985,477,481,500,713,6.1,5.6,6.7,6.1,10.3,1599,1722,1827,2072,1813,1905,1972,2272,대창단조,015230,1027
2090,1563,1752,2004,1672,897,963,1109,682,573,497,645,2675,1977,2138,2326,907,717,775,931,-2.6,4.0,-6.9,1.3,0.7,1445,1270,1289,1309,1768,1260,1363,1395,대한방직,001070,1027
25540,20743,18827,25149,4287,4642,6052,9706,1348,914,690,3075,19839,20265,21276,24789,2828,2479,2334,4497,11.5,13.0,5.3,6.1,6.5,14016,14791,15948,17280,17011,17786,18942,20292,대한유화,006650,1027
16488,15547,15968,19977,6318,7186,7215,9392,3667,8822,8009,7578,11729,12351,11995,14209,8510,9224,8398,10331,-3.4,-0.5,-1.1,0.2,2.2,2093,1897,1932,2229,3219,3127,3597,3878,대한전선,001440,1027
11338,10217,10961,20303,3498,2990,5812,8113,1947,1519,3743,4874,6571,6352,9449,12324,2222,1732,3965,5122,4.2,-2.5,4.6,6.7,15.0,4086,4345,4776,6141,4349,4620,5484,7202,대한제강,084010,1027
12084,12044,12145,12613,5065,5224,5330,5725,3894,4043,3913,4233,11354,11431,11462,11823,6835,6788,6677,6711,0.9,0.9,1.3,2.0,1.7,2379,2478,2635,2793,4519,4643,4785,5112,대한제당,001790,1027
8646,9339,9702,11113,4680,4310,4739,6839,1543,1783,2307,3801,9197,10051,10849,13216,1707,2453,3041,4410,5.9,5.7,1.8,2.0,7.3,6887,6999,7206,8349,7490,7598,7808,8806,대한제분,001130,1027
130116,123843,76105,90168,37500,35747,40025,66410,75568,87773,79878,84449,258425,270141,251901,266719,226799,242333,218783,198062,3.3,-0.6,-2.4,-0.9,2.2,2126,-3458,-5225,1101,31626,27808,33118,68657,대한항공,003490,1019
12846,10057,8841,11538,4984,4196,4312,5023,7813,7754,5967,3902,29329,33409,33456,38597,21534,24457,24923,23416,4.3,2.8,3.2,0.8,8.5,3302,3936,4024,6526,7795,8952,8533,15181,대한해운,005880,1019
2269,2627,3065,3187,1493,1020,1440,2251,891,951,1246,3854,2787,7270,8041,9003,965,3640,4061,3986,15.5,15.4,10.2,7.6,6.4,1451,1809,2149,2533,1822,3630,3980,5017,더존비즈온,012510,1026
837,867,1177,1152,584,609,608,752,280,334,344,369,1006,1029,1050,1253,377,399,388,403,0.5,-2.0,0.2,3.5,5.1,464,466,499,552,629,630,662,850,덕성,004830,1027
12922,13594,12920,13482,3287,3036,3052,3167,3664,4006,4075,4001,5263,5096,5130,5236,4490,4470,4573,4598,0.3,-0.5,-3.2,-1.8,0.3,72,-68,-111,-42,773,626,557,638,덕양산업,024900,1027
1863,2526,2297,2915,1699,2258,1953,2403,1404,1747,1933,1802,4368,5471,5102,5702,2421,3406,2816,2791,12.2,9.2,2.8,4.2,10.3,1597,1721,1950,2477,1947,2065,2286,2911,덴티움,145720,1027
4025,5161,5749,5774,1561,1755,2041,2286,1233,1442,1624,1930,3759,4090,4517,5002,1272,1564,1948,2333,3.7,3.9,4.4,4.2,3.2,2028,2102,2171,2237,2487,2526,2569,2669,도화엔지니어링,002150,1026
6509,6156,5308,5214,2034,2111,2236,2140,3406,3386,3333,3126,5703,5597,5661,5680,3909,3833,3964,3979,-7.0,-1.8,0.1,-2.0,-4.2,1386,1362,1261,1041,1794,1764,1697,1701,케이비아이동국실업,001620,1027
59649,56584,52062,72403,21739,19408,18462,26828,32291,28493,28058,31192,57302,54390,54185,63341,36980,34939,32823,35517,0.1,-5.2,-1.5,1.3,9.5,4838,4003,4485,9815,20322,19451,21362,27824,동국제강,001230,1027
5264,6330,5921,5959,1318,1829,1284,1425,3277,3739,2546,1744,5541,6284,5268,5313,4239,5128,4101,3998,-1.7,2.9,-1.5,2.3,-0.1,277,157,299,280,1302,1156,1167,1315,동방,004140,1019
1211,1246,1295,1341,1262,1340,1390,1543,276,312,333,454,1857,1940,1960,2045,527,569,542,574,3.4,3.4,3.4,3.5,3.5,1314,1350,1373,1401,1330,1371,1418,1471,동방아그로,007590,1027
8982,11554,11722,11449,4421,5733,5412,7816,2476,3617,2614,4107,7138,8919,9542,12620,3519,4713,4944,7023,14.7,11.0,7.5,4.8,10.5,1704,2180,2561,3532,3619,4206,4598,5597,동부건설,005960,1018
25451,24283,23424,33548,8859,7608,6492,11232,10191,6418,4760,8156,25061,23553,22577,27711,24996,14658,12850,16209,-10.0,-2.6,-1.4,2.9,7.6,-8863,-9215,719,2495,65,8895,9727,11502,KG스틸,016380,1027
5635,5054,4930,5353,7127,7298,7555,7804,585,571,559,587,14322,14783,15258,15826,1420,1272,1285,1340,9.3,8.5,9.7,8.0,7.4,11610,12269,12755,13226,12902,13511,13973,14486,동서,026960,1016
8131,8498,8640,9260,3337,3899,3498,3944,3311,3020,3024,3165,8081,8505,7979,8188,4074,4321,3707,3618,-0.7,-0.6,3.0,4.5,5.2,932,897,863,923,4007,4184,4272,4570,동성케미컬,102260,1026
7075,7697,7833,8819,2917,3153,3294,3586,3199,4144,3484,4673,12419,13586,15111,16914,5062,6117,6224,7063,2.3,-12.1,1.5,11.3,3.8,4780,4846,6394,6939,7357,7469,8887,9851,동아쏘시오홀딩스,000640,1021
2408,2162,2245,3636,1277,1205,1174,1588,753,810,857,1226,2124,2147,2495,2985,857,914,1301,1732,9.7,8.3,0.9,-3.4,-0.2,988,971,892,866,1267,1233,1194,1253,다스코,058730,1027
5674,6123,5867,5932,4265,4533,4622,5310,2690,2161,1477,2755,9487,10088,9807,11160,3693,3629,3386,4596,-0.6,0.9,7.3,2.7,1.2,1026,1634,1734,1804,5794,6459,6421,6564,동아에스티,170900,1027
3607,3809,3146,2895,2104,2178,2433,2396,1090,1266,1360,1450,2848,3223,3348,3508,1100,1284,1433,1464,6.2,6.9,6.3,0.6,1.4,1274,1435,1442,1490,1748,1939,1915,2044,동아지질,028100,1018
5297,5391,6029,6996,4122,3882,3523,4137,1229,1638,1806,1869,9776,10174,9968,10072,1434,1983,2172,2232,1.6,0.3,-0.2,-2.9,1.1,1490,1368,1071,1176,8342,8191,7796,7840,동양,001520,1027
1323,1405,835,812,356,283,93,177,595,322,417,624,1959,1868,1679,1688,833,546,608,843,-0.8,0.7,17.1,-9.3,-14.2,506,729,488,265,1126,1322,1071,845,동양고속,084670,1019
700,116,99,129,1001,180,127,432,976,536,409,713,1906,986,692,1131,1022,571,462,944,-20.5,-8.0,-27.4,-58.8,-32.4,-498,-971,-1459,-996,884,415,230,187,비케이탑스,030790,1026
5899,6174,7133,8415,3616,3943,4067,4101,3235,3941,3863,3810,5815,6286,6569,7074,4773,4815,4861,4582,-4.1,-4.1,0.9,1.0,5.8,453,490,533,813,1042,1471,1708,2492,TYM,002900,1027
1620,1634,1738,1820,808,794,695,1017,794,758,596,929,1636,1642,1534,1860,846,844,659,1019,-19.7,-4.2,1.1,4.4,-2.2,-325,-316,-237,-275,790,798,875,841,동양철관,008970,1027
3322,3648,3215,3546,1373,1599,1548,1698,1697,1775,1962,1746,3176,3503,3461,3626,2221,2421,2505,2494,3.2,3.8,3.0,-2.0,2.2,701,800,720,788,955,1082,956,1132,동양피스톤,092780,1027
28025,30303,31703,34906,6314,6790,7018,9207,3417,5164,4499,6913,14036,15735,16839,19357,7711,8923,9370,11369,4.2,4.1,4.4,4.8,3.8,5260,5801,6465,7025,6325,6812,7469,7988,동원F&B,049770,1027
4586,4566,3695,2833,1293,1708,1592,1383,3125,3205,3123,2868,4880,5110,4689,4418,4434,4414,4369,3947,-2.4,-3.5,3.4,-5.7,3.5,29,233,-138,-19,446,696,320,471,동원금속,018500,1027
10263,10424,10785,12509,4649,4218,4538,6385,3687,2165,4507,5149,11241,11546,12558,14920,5875,5808,6394,8266,6.8,5.5,4.1,5.1,3.5,1909,2162,2548,2792,5366,5738,6164,6654,동원시스템즈,014820,1027
2630,2619,2432,2775,1549,1535,1504,1694,817,715,593,884,2848,2814,2758,3138,978,879,759,1048,0.4,3.7,2.9,2.6,2.1,783,845,908,943,1870,1935,1999,2090,동일고무벨트,163560,1027
9093,6849,6797,8131,3189,2565,2635,3495,3221,2650,2389,3065,9476,8884,8826,9931,4350,3930,3659,4196,-0.4,1.5,1.5,2.7,4.9,5074,5052,5219,5609,5126,4954,5167,5735,DI동일,001530,1016
3910,3547,3333,4644,2993,2741,2810,3142,485,392,422,619,4097,4049,4175,4738,548,510,570,717,6.1,3.9,0.9,2.0,9.8,3422,3422,3488,3904,3549,3539,3605,4021,동일산업,004890,1027
3066,3072,2721,2930,2279,2355,2227,2202,608,557,675,665,3706,3764,4338,4478,732,766,911,877,13.6,2.7,2.4,7.1,4.4,2431,2456,2702,2903,2974,2998,3427,3601,동화약품,000020,1027
174493,180416,114285,132042,115859,110480,125983,98953,133169,162058,158082,120064,288803,291697,302010,260099,217352,223502,224354,175128,0.2,-1.2,1.5,-3.3,2.3,9601,12507,11593,14681,71451,68195,77656,84971,두산,000150,1026
39708,45096,42821,58162,16837,15196,18620,26459,9635,11391,10117,14982,64463,67042,69606,85809,27067,27252,28868,42596,4.4,4.2,4.1,3.6,5.0,9991,13896,14610,20467,37396,39790,40738,43213,두산밥캣,241560,1027
5113,6743,8300,5990,2818,3802,2766,3449,4903,6207,4976,4311,7434,8301,7233,7956,5124,6416,5292,5865,-0.8,-1.9,-5.3,0.8,-5.2,61,-359,-296,-708,2310,1885,1941,2091,HSD엔진,082740,1027
77301,81858,39881,45937,44268,43049,50496,32398,37786,44844,38826,27688,110292,113386,120269,47823,72084,70710,75379,34125,2.9,3.7,3.5,2.4,6.8,10492,12579,14081,18791,38208,42676,44890,13698,현대두산인프라코어,042670,1027
147611,156597,91715,112836,97822,93516,99468,84176,115046,137732,130705,101258,248149,248092,255672,237205,185965,186073,184607,149130,-0.4,-1.7,-0.4,-3.3,2.6,-1489,-9742,-20466,7732,62184,62019,71065,88075,두산중공업,034020,1027
4831,4659,4658,4956,1820,1980,2433,2580,1322,1538,1584,1490,3466,3643,4057,4241,1827,1873,2223,2268,5.1,4.4,3.7,1.5,3.8,672,788,816,941,1639,1770,1834,1973,두올,016740,1027
1960,1095,1623,2266,887,1010,1031,1211,492,559,547,632,2105,2148,2289,2491,664,725,905,953,10.2,7.1,0.2,2.6,6.3,783,768,816,950,1441,1423,1384,1538,디아이,003160,1027
5532,5378,4934,5901,3287,3090,2100,2171,5038,4722,4553,4284,8103,7798,6046,6289,6238,5937,5340,4963,0.1,-0.9,-7.0,-17.2,4.8,702,157,-1041,-728,1865,1861,706,1326,디아이씨,092200,1027
8910,8543,7894,9984,4129,4038,4629,5340,2151,2145,2590,3011,7425,7545,7956,8600,2967,2802,3284,3618,5.6,3.1,4.3,0.4,1.4,2487,2606,2456,2388,4458,4743,4672,4982,디와이,013570,1021
3857,3435,3048,4372,1458,1480,1776,2252,917,802,819,1071,2585,2626,2878,3420,1084,956,988,1161,12.6,9.9,7.3,9.2,9.9,631,795,820,1109,1501,1670,1890,2259,디와이파워,210540,1027
9085,9298,8031,9308,4547,4319,4761,10771,2843,2684,2909,5581,8708,9117,9618,14850,3072,2856,3071,7710,5.7,7.1,7.7,5.2,7.0,8317,8880,9193,9788,5636,6261,6547,7140,디티알오토모티브,007340,1027
1577,1645,1741,3127,1203,1251,1441,1964,441,589,638,965,1937,2209,2495,3420,460,644,690,1098,3.9,6.1,5.4,8.5,19.7,920,1000,1165,1711,1477,1565,1805,2322,스틱인베스트먼트,026890,1021
4343,4860,5020,5430,3777,4095,4140,5420,616,674,701,1013,7394,7999,7832,8297,788,1159,1179,1358,4.7,4.2,2.1,1.5,2.0,3761,3864,3750,3691,6606,6840,6653,6939,락앤락,115390,1027
761,884,168,1071,2201,531,1248,915,745,2507,2124,2404,5068,5750,11985,13024,2258,2693,9724,12497,0.9,-24.9,-2.7,-9.3,-16.1,-2452,-2643,-3455,-5447,2810,3057,2261,527,롯데관광개발,032350,1026
178208,176220,161844,155736,57084,61073,62907,70002,66037,82019,87800,89942,262593,339726,328294,334265,138319,221816,217406,216295,-0.1,-1.7,-2.7,-2.1,-0.8,109916,99102,91766,89966,124274,117910,110888,117970,롯데쇼핑,023530,1016
13717,13113,12636,17803,7164,8605,5168,8669,2285,2825,1697,3090,17000,17927,18746,27235,3221,2996,2249,5248,5.6,12.9,9.6,10.8,25.5,9460,10631,12191,17685,13779,14931,16497,21987,롯데정밀화학,004000,1027
72712,88562,90866,99249,154769,31266,49026,47725,163397,37869,47455,45670,276183,156058,166800,199219,191849,78132,88489,102926,3.8,0.5,-1.9,-1.5,0.8,60294,49072,47663,50808,84334,77926,78311,96293,롯데지주,004990,1021
23463,24295,22580,25061,6887,7884,8933,9945,6890,9416,8649,9710,33113,32565,34661,35968,20739,20285,21612,21518,3.0,-1.5,-4.4,-0.5,3.9,20833,19083,18762,19615,12374,12280,13049,14450,롯데칠성,005300,1027
160731,151235,122230,181205,81439,72209,68765,94307,39614,27400,28677,45791,207991,200431,193865,228700,72548,59900,56742,74188,12.9,8.1,3.7,0.9,6.8,117847,121584,120769,133075,135443,140531,137123,154512,롯데케미칼,011170,1027
18108,17880,15223,16078,4502,6245,5520,4824,1810,4538,3178,2573,12083,13212,12865,12715,5258,6136,5253,4855,7.4,3.5,3.0,5.4,-0.1,9117,9229,9816,9699,6825,7076,7612,7860,롯데푸드,002270,1027
2691,2417,2148,2527,370,301,462,698,792,589,892,889,1933,1830,1921,1965,899,952,1202,1492,-4.5,-5.1,-9.3,-18.8,-25.8,-374,-549,-911,-1410,1034,878,719,473,마니커,027740,1027
56648,59819,55635,61474,19727,21098,24070,29443,18358,17568,20316,21296,44373,45956,49383,57044,29555,30100,32288,36601,0.4,2.5,2.6,0.3,3.4,6812,7545,7223,9155,14818,15856,17095,20443,만도,204320,1027
378,77,97,75,108,108,278,258,154,122,312,292,195,154,334,287,159,128,318,297,-48.0,-56.7,-145.0,-80.9,-36.0,-222,-475,-671,-754,36,26,16,-10,쎌마테라퓨틱스,015540,1026
1475,1493,1279,1448,1070,1007,806,669,1234,1334,1253,1125,2431,2644,2430,2227,1500,1842,1523,1368,3.6,0.1,-8.2,-10.9,-2.9,151,-83,-337,-400,931,802,907,859,명문제약,017180,1027
1352,1320,1278,1322,777,813,743,1123,551,822,583,645,1706,2007,1957,2025,961,1096,1059,980,1.7,0.5,0.7,0.0,7.9,297,423,413,556,745,911,898,1045,모나미,005360,1016
1953,2076,1786,1961,3389,3416,3605,3766,254,268,232,254,4324,4409,4424,4480,295,330,278,292,2.9,2.0,2.6,3.4,2.7,3699,3746,3823,3861,4029,4079,4146,4188,모토닉,009680,1027
6512,6313,5279,6137,4149,3190,3617,3432,4625,3924,4320,5274,13560,13503,14304,14836,7216,7298,8290,8647,3.3,5.7,0.8,-0.5,1.4,3448,3401,3209,3365,6344,6205,6014,6189,무림P&P,009580,1027
11091,11237,9497,10553,6705,5957,6423,6754,7947,7714,7458,9168,20143,21585,21950,22844,13467,14706,15501,16379,2.1,3.1,-0.3,-1.7,0.0,1680,1554,1166,1111,6676,6879,6449,6465,무림페이퍼,009200,1027
1937,1558,1394,1269,761,1150,1024,560,1005,937,683,1436,6190,6246,5988,6466,1125,1097,740,1481,8.1,-3.1,3.8,2.2,-2.6,4867,5005,5138,4933,5065,5149,5248,4985,무학,033920,1027
345,277,416,483,474,517,397,701,161,47,193,291,687,748,958,1177,211,85,317,331,-16.2,-17.4,-8.6,-7.9,7.0,-501,-559,-626,-557,476,663,641,846,미래산업,025560,1027
3286,2500,2950,3598,1117,1202,1377,1716,342,355,356,466,2455,2807,3290,3724,479,561,614,764,9.7,9.0,11.8,17.0,16.5,1565,1828,2527,2838,1976,2246,2676,2960,미원상사,002840,1027
1420,1884,2890,4214,684,929,962,1351,489,500,664,1097,2220,3152,3313,4268,899,1176,1330,1911,6.1,5.1,6.1,7.3,10.6,326,470,632,1029,1321,1976,1983,2357,미원홀딩스,107590,1021
3163,3237,2776,4063,2127,2095,2191,2604,317,318,275,392,2832,2954,3118,3476,331,374,347,456,4.5,3.8,6.1,6.5,10.1,2399,2539,2705,3004,2501,2580,2771,3020,미창석유,003650,1027
1319,1165,1310,423,1484,1526,1751,1628,417,371,485,468,2369,2369,2571,2474,470,449,573,562,1.2,2.4,2.2,3.0,-0.3,858,889,956,936,1899,1920,1998,1912,방림,003610,1027
1755,1684,1713,1911,405,664,483,547,1052,940,841,1255,2977,3288,3227,3592,1438,1615,1455,1697,2.3,7.7,5.1,3.1,4.4,70,204,264,387,1539,1673,1772,1895,백광산업,001340,1027
2126,1864,1653,1952,784,1031,1026,1238,726,699,532,660,2938,3014,2959,3324,1009,985,871,975,2.5,2.0,3.3,3.1,4.9,682,692,718,793,1929,2029,2088,2349,태경비케이,014580,1027
3231,4689,3831,3711,1774,1967,1766,2098,1315,1559,1352,1482,2947,3306,2911,3302,1566,1884,1687,1831,4.6,6.1,2.0,-5.3,6.2,997,1032,842,1011,1381,1422,1224,1471,백산,035150,1027
1556,2761,1444,1119,650,708,798,1224,591,400,553,731,1184,1385,1581,1985,682,685,765,1123,0.9,4.5,15.4,7.4,2.4,-328,81,190,240,502,700,816,862,범양건영,002410,1018
4324,4335,4395,4714,2275,2014,2060,2076,1218,1340,1468,1578,4746,4627,4644,5054,1789,1712,1727,2151,2.9,1.8,-0.4,0.3,-0.3,1845,1794,1790,1750,2957,2915,2917,2903,벽산,007210,1027
4604,5243,5619,6273,2245,2319,3157,4373,1297,1392,1229,1560,4500,5076,6480,8286,1939,2247,3077,3543,14.1,4.8,6.7,4.7,5.8,2468,2737,2958,3348,2561,2829,3403,4743,보령제약,003850,1027
820,760,786,837,753,581,500,597,750,554,534,443,2005,1631,1491,1531,1311,867,705,689,5.1,-13.3,-11.1,1.1,-0.6,-290,-257,-93,-59,694,764,786,842,보해양조,000890,1027
1942,1682,1697,1825,2216,1864,2482,2201,382,359,612,370,4936,3885,4010,3974,802,620,1298,1174,4.7,39.9,-1.7,-2.6,-0.7,3350,3104,2733,2647,4134,3265,2712,2800,부광약품,003000,1027
1194,1410,1156,1280,651,677,604,623,480,484,404,431,1336,1360,1290,1338,622,583,476,563,3.9,2.8,5.2,3.1,-2.5,363,396,416,393,714,777,814,775,부산산업,011390,1027
1619,1994,1723,2156,1174,1493,1157,1196,438,646,553,675,2543,2862,2632,2715,474,718,673,716,7.3,0.9,4.1,-5.4,2.3,1587,1665,1484,1529,2069,2144,1959,1999,비상교육,100220,1026
8552,8783,9591,11474,3858,4051,3253,3139,957,943,1263,1600,6539,6849,7641,7602,1089,1138,1746,2024,4.7,5.3,6.1,4.8,-2.5,4546,4810,5016,4684,5450,5711,5895,5578,빙그레,005180,1027
9371,13297,17181,18137,2692,4331,4848,5251,3202,4709,4966,5233,7209,10709,11241,11398,4046,6470,6725,6208,6.3,2.1,9.7,3.3,5.9,1656,2451,2765,3404,3163,4239,4516,5190,사조대림,003960,1027
4130,4122,3876,4121,1815,1856,1768,1946,2788,2332,2143,2304,4682,4669,4464,4488,2910,2699,2387,2370,6.1,3.3,0.2,2.1,0.5,-76,131,228,252,1772,1970,2077,2118,사조동아원,008040,1027
2653,2842,1065,18984,1974,1780,9795,8298,4170,3495,13856,11158,7591,6959,26754,25916,4417,3833,19976,18521,0.5,-1.5,0.1,1.9,3.7,2364,2342,927,1305,3174,3126,6778,7395,SGC에너지,005090,1017
1774,2263,3794,3570,2761,2592,3888,4464,1461,1333,2304,2538,4131,4207,4888,5514,2228,2201,3077,3129,-9.9,-12.8,1.8,-4.7,1.5,-567,154,1,102,1903,2006,1811,2385,삼부토건,001470,1018
91583,100974,112948,135532,55193,51814,56574,74449,40128,37415,49836,64613,193497,198521,215342,258332,71245,71918,81753,106365,4.2,4.3,2.1,3.1,5.3,66125,69069,74181,85165,122252,126603,133589,151967,삼성SDI,006400,1027
809,752,638,796,1455,1267,1540,1589,411,350,320,349,2602,2584,2582,2575,463,397,356,378,4.3,2.4,1.9,2.1,-1.0,2055,2094,2142,2113,2139,2187,2226,2197,삼성공조,006660,1027
311556,307615,302161,344552,136713,117537,129236,151440,130168,109294,108896,116753,424067,459055,543317,552454,198577,192134,213863,218930,1.0,3.8,2.4,2.3,3.3,69495,76010,83271,95481,225490,266921,329454,333524,삼성물산,028260,1016
5358,7016,11648,15680,15777,13563,17513,28232,7105,6905,5893,11073,59804,59116,64242,79700,18249,15572,18254,29789,-1.3,3.4,3.4,3.9,5.5,15097,17126,19536,23472,41555,43544,45988,49911,삼성바이오로직스,207940,1027
100342,107196,110174,136300,58818,63838,65812,75760,15748,16982,17208,23703,80138,90212,91549,105174,18653,22961,22958,30737,7.7,8.4,8.8,5.0,6.4,48217,54035,56613,60868,61485,67251,68591,74437,삼성에스디에스,018260,1026
54670,63921,67492,74867,29522,29018,31359,44425,33782,29775,29611,38527,46196,45657,47556,60587,36218,32705,31738,40982,-1.4,1.3,7.1,5.4,6.5,1978,5186,6889,10116,9978,12952,15818,19605,삼성엔지니어링,028050,1026
80020,77183,77533,96750,35253,35075,41503,45983,25096,18504,19149,22347,86449,86742,92255,99414,36984,32442,33151,30702,2.3,8.4,6.1,7.0,9.6,31793,35729,40733,48072,49465,54300,59104,68712,삼성전기,009150,1027
2437714,2304009,2368070,2796048,1746974,1813853,1982156,2181632,690815,637828,756044,881171,3393572,3525645,3782357,4266212,916041,896841,1022877,1217212,15.0,13.8,6.3,7.2,9.9,2426990,2545829,2710682,2930648,2477531,2628804,2759480,3049000,삼성전자,005930,1027
52651,73497,68603,66220,74055,69295,66980,55936,62671,70891,75339,70583,142829,136001,129222,121386,75366,83512,92039,80413,-2.2,-2.8,-9.4,-11.3,-11.6,28001,15022,301,-13552,67463,52489,37183,40973,삼성중공업,010140,1027
1861,2020,1671,1875,846,949,945,1086,556,707,608,625,1907,2416,2924,3387,748,1202,1187,1153,3.3,0.2,3.1,20.0,1.9,543,582,1107,1171,1159,1214,1737,2234,삼성출판사,068290,1026
87,80,74,73,12805,6493,14418,14697,271,109,99,50,230421,220382,233989,271442,14,5,4,3,0.8,2.3,2.4,2.2,1.9,43807,45432,47717,51265,230407,220377,233985,271439,삼성카드,029780,1021
1713,1911,1970,2530,751,791,764,991,761,864,791,926,1967,2085,2075,2272,911,996,971,1052,0.1,1.4,2.4,1.7,5.6,954,986,1001,1118,1056,1089,1104,1220,삼아알미늄,006110,1027
21238,20964,20518,23845,6521,8075,9227,9852,4738,4001,4657,7492,21739,23882,25765,28020,9079,10937,12235,13761,2.3,2.8,2.3,3.1,2.1,2220,2404,2874,3130,12660,12945,13530,14259,삼양사,145990,1027
4694,5436,6485,6420,1297,1846,2000,2789,1387,1495,1636,1824,4121,4704,5562,7531,1777,1827,2089,3574,8.0,8.7,13.6,13.2,8.7,1777,2311,2905,3385,2344,2877,3473,3957,삼양식품,003230,1027
1832,1921,1984,1940,2329,2658,3172,3501,255,309,334,408,3275,3717,4221,4590,347,429,465,526,8.3,7.9,12.6,12.6,7.5,2362,2778,3248,3545,2928,3288,3756,4064,삼양통상,002170,1027
25635,24886,24712,31073,10572,12595,14759,16510,6565,5271,6820,10028,33138,35895,38936,44606,13119,15600,17378,20352,2.1,3.1,1.8,3.8,6.6,9708,9849,10710,12916,20019,20295,21558,24254,삼양홀딩스,000070,1021
2693,2742,3924,4670,2375,3090,3105,3366,349,839,825,861,3865,5173,5332,5788,520,1171,1119,1146,8.2,7.7,7.2,6.6,8.1,2964,3270,3492,3809,3345,4002,4213,4642,삼영무역,002810,1016
2497,2010,2006,2389,3260,3229,3416,3723,254,164,204,293,5080,5027,5139,5436,276,183,230,319,2.1,3.0,1.7,2.3,3.2,3199,3307,3367,3486,4804,4844,4909,5117,삼영전자,005680,1027
1029,1111,1177,1333,447,454,459,513,482,525,506,569,1052,1070,1090,1177,589,627,632,671,-23.6,-7.2,-1.8,1.1,3.2,-73,-22,8,48,463,443,458,506,삼영화학,003720,1027
2400,2654,2479,2954,1625,1766,2060,2739,2125,1525,2354,2076,5944,6129,6224,5853,3829,3887,3995,3314,-1.1,2.3,2.2,1.6,3.9,1713,1799,1849,2053,2115,2242,2229,2539,삼익악기,002450,1027
946,1211,1230,1342,592,792,725,767,853,682,987,1217,1479,1839,1917,2264,919,1216,1281,1607,-1.1,-6.0,0.5,0.7,-2.6,365,352,350,277,560,623,636,657,삼일제약,000520,1027
34562,34616,32080,37633,11748,13157,12536,15517,7585,9733,7305,9135,36994,39124,38599,42453,23311,25194,24691,27852,0.1,0.7,1.0,0.7,1.8,12652,12906,13095,13619,13683,13930,13908,14601,삼천리,004690,1017
2987,3646,3634,3173,1587,1796,1959,1724,862,954,898,624,2769,2988,3128,2969,928,1080,1014,761,8.5,7.7,7.5,6.1,4.6,1485,1653,1808,1909,1841,1908,2114,2208,삼호개발,010960,1018
1080,1160,1403,1499,622,546,570,508,174,304,330,322,1718,2387,2461,2433,329,936,1019,997,5.1,5.8,4.1,0.6,0.6,994,1056,1048,1042,1389,1451,1442,1436,삼화왕관,004450,1027
2047,1951,1993,2471,706,670,774,972,542,473,513,555,1282,1252,1370,1586,692,639,693,718,7.7,5.4,2.8,4.4,10.5,141,161,181,322,590,613,677,868,삼화전기,009470,1027
421,418,401,443,179,170,140,159,328,327,288,353,643,604,550,669,450,442,412,493,-19.7,-6.8,-5.2,-4.0,-6.8,-291,-313,-334,-367,193,162,138,176,삼화전자,011230,1027
2744,2545,2425,2622,1390,1014,1200,1479,853,534,479,527,2200,2148,2350,2693,927,609,601,664,12.0,34.6,13.7,10.4,11.4,1058,1319,1519,1770,1273,1539,1749,2029,삼화콘덴서,001820,1027
5242,5403,5517,6316,2752,2758,3052,3032,1529,2177,2079,2181,5580,5606,5943,6121,2762,2785,3020,3162,0.4,0.2,0.7,1.1,-0.4,2724,2728,2764,2708,2818,2821,2923,2959,삼화페인트,000390,1027
3787,3919,3490,3970,2362,2495,2493,2969,1904,2045,2106,2630,4293,4523,4400,4936,2558,2754,2698,3052,6.4,2.4,1.3,-0.5,2.2,1626,1622,1590,1692,1735,1769,1702,1884,상신브레이크,041650,1027
1676,1527,1357,1276,1500,1407,1391,1505,270,263,232,253,2671,2555,2481,2684,447,426,302,300,5.0,2.8,-3.2,2.4,5.4,2084,1968,2008,2134,2224,2129,2179,2384,새론오토모티브,075180,1027
2759,2810,3191,3490,1226,1339,1763,2100,551,554,560,846,3209,3386,3812,4427,879,822,901,1293,6.0,6.7,7.5,9.8,5.6,1144,1247,1422,1761,2330,2564,2911,3134,샘표,007540,1021
2756,2808,3189,3487,844,948,1366,1696,525,537,562,832,2055,2258,2686,3275,738,688,765,1126,5.9,9.0,12.4,14.6,8.0,334,589,941,1168,1317,1570,1921,2149,샘표식품,248170,1027
20784,22026,22373,24793,12414,9193,9376,9077,13935,11336,10364,9826,26963,22154,21510,21379,17460,14104,13244,12316,-0.8,-1.6,-3.9,-1.2,2.1,7163,6555,1672,1896,9503,8050,8266,9063,서연,007860,1021
18508,19768,19624,21801,8532,7904,8097,7718,8649,9624,9120,8692,16962,18205,18038,17905,10296,11989,11718,10928,1.7,-0.5,-2.8,-2.3,1.7,2228,1715,1324,1568,6666,6216,6320,6977,서연이화,200880,1027
13890,13610,12807,12778,5994,7355,8660,7376,1961,3316,3833,3623,13686,15834,16897,16626,4211,6156,6552,6238,2.4,2.9,2.0,8.0,0.5,9347,9553,10233,10263,9475,9678,10345,10388,서울가스,017390,1017
2580,2577,1947,2616,893,915,968,1261,1040,1048,898,1000,2201,2220,2260,2934,1148,1143,1204,1574,0.9,3.3,1.4,-2.5,4.8,248,271,214,361,1053,1077,1056,1360,서원,021050,1027
3935,4607,5530,5967,2140,2646,3141,3186,1939,1963,2673,2364,6391,7089,7660,8100,3309,3799,3890,3801,4.5,4.8,5.5,8.0,7.5,2422,2700,3175,3636,3082,3290,3770,4299,서흥,008490,1027
838,893,862,833,709,715,723,669,248,404,372,442,1491,1670,1756,1679,653,805,823,868,1.1,-0.5,-1.4,1.5,-5.8,425,427,452,343,838,865,933,811,선도전기,007610,1027
9124,10140,13481,17183,4148,4403,5387,6218,4678,5075,6090,6610,9172,9833,11197,12096,5860,6520,7357,7798,9.0,2.3,2.1,8.1,3.6,2141,2332,3113,3524,3312,3313,3840,4298,선진,136490,1027
5623,4559,4125,4653,2793,2251,2255,2726,2718,2293,2343,3059,6253,5436,5284,5662,3702,3268,3251,3979,-1.6,-1.5,-6.8,-2.0,-6.5,1329,963,859,515,2551,2168,2033,1683,SUN&L,002820,1027
413,359,379,493,256,221,231,349,129,124,116,117,433,425,404,544,139,151,138,236,-6.1,0.5,-4.3,-2.3,6.3,123,102,93,123,294,274,266,308,성문전자,014910,1027
495,419,517,577,1024,941,828,901,143,166,130,270,1834,1724,1592,1722,297,258,225,364,4.9,3.3,-1.6,-3.6,0.8,978,907,821,808,1537,1466,1367,1358,성보화학,003080,1027
6881,7074,7223,8335,2821,2568,2828,3116,4970,4387,4727,4726,10614,10294,10903,11216,6745,6291,6828,7076,1.2,1.6,1.7,1.0,0.6,2300,2238,2303,2357,3869,4003,4075,4140,성신양회,004980,1027
2202,2169,1280,789,1431,1570,1051,496,1551,1688,1809,661,2885,3114,2450,1416,2108,2321,2453,1054,-3.2,-7.0,-5.4,-17.3,10.6,137,130,-509,-259,777,793,-3,362,성안,011300,1027
1370,1510,1709,1979,857,806,787,740,767,950,888,897,6487,7033,7074,7037,1593,1779,1745,1645,0.6,-1.2,-1.6,0.7,0.8,2008,1903,1957,2021,4894,5254,5329,5392,성창기업지주,000180,1026
6517,7233,8422,10577,1852,2292,2672,3552,1103,1744,1889,2295,9889,11160,11646,12453,1731,2897,3112,3481,3.3,4.5,0.6,2.9,4.4,6237,6285,6573,7132,8158,8263,8534,8972,세방,004360,1019
11809,11390,12528,13520,7886,8719,9739,10576,2750,4282,3539,4316,12679,15107,15143,16844,2855,4560,3782,4724,6.0,8.0,5.6,4.4,5.3,9259,9994,10625,11409,9824,10547,11361,12120,세방전지,004490,1027
32781,29365,25358,36511,13809,13448,13404,16360,9818,7358,7569,9109,37189,35769,32804,35260,17239,15938,15667,16196,3.9,0.7,0.5,-7.2,5.4,12452,12319,9748,11624,19950,19831,17137,19064,세아베스틸,001430,1027
17817,26439,23064,28417,12848,12852,11716,17115,8089,7698,6707,9285,24454,24485,23156,28990,10928,10962,9848,13123,1.3,13.3,0.6,1.4,8.7,14700,8316,8457,10227,13526,13523,13308,15867,세아제강지주,003030,1021
7236,7175,6550,8958,3232,3742,3681,4694,1627,2249,1882,2726,5000,5732,5524,6511,1749,2458,2376,3108,4.5,2.2,2.1,-0.8,4.5,2365,2389,2272,2485,3251,3274,3148,3403,세아특수강,019440,1027
51769,49307,42574,60055,22206,23263,22719,28246,15298,13629,13634,17375,54539,54567,50849,55378,24466,24243,23579,26750,4.1,1.2,0.9,-5.0,2.5,15868,16044,14398,15105,30073,30324,27270,28628,세아홀딩스,058650,1027
322,275,275,324,347,362,395,414,107,56,41,43,434,455,471,496,107,57,41,44,1.1,1.3,0.2,6.7,4.4,86,86,118,139,327,398,430,452,세우글로벌,013000,1016
1338,1819,1099,832,1116,1437,1020,1061,1200,1139,1273,1032,3295,3587,3247,2927,1617,1821,1546,1225,-2.1,-5.0,-1.7,-7.8,-0.8,-315,-378,-643,-675,1678,1766,1701,1702,세원이앤씨,091090,1027
1907,1569,1425,563,3651,2492,2634,2777,845,712,437,400,6195,6128,6222,6343,1077,948,708,678,-2.2,-2.9,0.8,4.0,-0.7,3982,4055,4302,4308,5118,5180,5514,5665,세원정공,021820,1027
10995,12217,11828,15881,4758,5591,6993,7214,4676,5313,6719,6879,8710,9960,11588,11801,5096,6148,7706,7772,-0.8,-2.2,0.2,-2.0,-0.9,3626,3667,3494,3447,3614,3812,3882,4029,세종공업,033530,1027
2182,2959,2856,2504,864,1379,1102,1995,1939,2022,1651,2414,3683,4086,4481,5704,2099,2463,2870,3672,0.5,0.5,0.8,0.8,2.8,1256,1263,1270,1359,1584,1623,1611,2032,세진중공업,075580,1027
1208,994,768,530,700,522,736,749,1298,1126,377,565,1721,1610,1503,1160,1440,1395,868,742,-12.6,-21.2,-3.3,-24.9,-19.4,-533,-591,-979,-1232,281,215,635,418,다이나믹디자인,145210,1027
7887,8143,8078,9982,3916,3988,4122,6284,3767,2934,2931,4440,8725,8943,8911,11156,4613,4597,4276,5724,4.1,4.4,4.0,3.2,7.1,3805,3998,4334,5124,4112,4346,4635,5432,송원산업,004430,1027
846,1578,1378,2530,1006,859,1387,1383,491,542,1175,1065,2049,1832,2364,2361,1060,828,1328,1140,2.6,4.2,0.1,1.9,4.8,719,729,763,870,989,1004,1036,1221,수산중공업,017550,1027
2802,2716,2648,3192,861,966,997,1253,427,387,386,507,2988,3081,3091,3318,669,603,565,685,-1.8,5.8,5.9,2.7,5.0,1938,2097,2155,2292,2319,2478,2526,2633,한국수출포장,002200,1027
6908,6946,6987,7632,3017,4591,4804,4085,1124,1235,1532,2497,8160,8483,9195,12756,1498,1428,1750,4697,7.3,6.5,6.7,6.6,5.7,3851,4230,4647,5118,6662,7055,7445,8059,스카이라이프,053210,1026
7094,6468,6092,6816,2070,2443,2810,3182,1478,1037,1196,1125,7468,7686,8091,8460,2403,1948,2096,2192,5.0,13.4,9.5,5.8,7.3,3254,3774,4177,4687,5065,5738,5995,6268,신대양제지,016590,1027
5579,4271,3358,3219,7668,7747,7469,8750,633,625,573,649,9502,9475,9162,10226,787,769,677,739,3.4,3.7,1.5,-1.4,9.8,7197,7184,6952,7906,8715,8706,8485,9487,신도리코,029530,1027
4247,4028,4824,4545,1598,1769,1852,2512,2720,2775,2046,2250,4131,4166,4234,4767,2991,2944,2320,2686,-5.7,2.0,0.5,-3.3,-3.5,-655,-634,-771,-930,1140,1222,1914,2081,신성이엔지,011930,1027
9549,10272,11999,7432,4389,4756,5103,6302,3557,4528,4197,4846,6919,8583,8985,10256,4631,6276,6335,7115,0.4,0.4,0.0,3.3,10.2,861,856,1144,1726,2288,2307,2650,3141,신성통상,005390,1016
51857,63942,47693,63164,18369,18312,16637,19104,32448,31730,36090,35705,111013,130185,127691,136445,60991,75034,77119,78821,2.1,2.7,4.9,-0.5,2.9,24392,29209,27882,30845,50022,55151,50572,57624,신세계,004170,1016
12627,14250,13255,14508,4037,4363,4268,4598,2462,2923,3002,2038,9825,11289,11475,11591,4376,5296,5062,4395,2.5,6.0,7.0,4.5,7.2,3889,4434,4848,5611,5449,5993,6413,7196,신세계인터내셔날,031430,1016
12786,13201,12403,13329,2145,2839,2471,2718,1867,2605,2467,1771,6250,7333,8872,8795,3081,4182,6039,5947,3.6,1.4,0.6,-2.7,0.3,2293,2278,1974,1971,3169,3151,2833,2848,신세계푸드,031440,1026
1633,2630,2059,1864,394,658,303,356,359,642,394,541,2053,1999,1678,2482,802,1092,773,1529,-3.3,-6.0,-17.0,1.5,3.6,400,56,74,136,1251,907,905,953,신송홀딩스,006880,1016
1742,1781,1780,1894,1517,1496,1784,1703,256,273,455,540,3452,3483,3734,3887,320,339,563,658,2.7,1.3,0.8,0.8,1.7,2533,2535,2566,2606,3132,3144,3171,3229,신영와코루,005800,1027
6215,6749,6943,8794,2738,2726,2731,3484,2031,1391,1358,1948,4123,4034,4058,5036,2293,2019,2202,2921,-2.3,-1.5,0.1,-2.3,2.3,1182,1199,1125,1237,1830,2015,1856,2115,신원,009270,1027
1874,1897,1978,1892,2246,2192,3328,2272,1462,1340,833,286,3810,3801,4872,3926,1735,1710,1128,380,0.2,0.7,1.4,1.2,-2.6,1437,1465,1566,1392,2075,2091,3744,3546,신풍제약,019170,1027
1541,1569,338,259,839,1140,661,737,1078,1144,55,38,1673,1856,1078,939,1151,1167,73,45,0.5,5.4,11.1,22.4,-10.0,435,603,918,804,522,689,1005,894,신풍제지,002870,1027
1215,1230,1167,1269,567,499,615,540,400,445,506,362,1327,1389,1462,1386,454,587,543,372,2.4,2.3,0.5,8.7,9.5,738,666,783,888,873,802,919,1014,신흥,004080,1016
1017,955,972,970,914,817,971,2713,1446,1479,1055,1449,3802,3404,3505,3956,1761,1743,1351,1673,33.9,-19.0,-10.1,-4.7,-5.0,335,-35,-220,-408,2041,1661,2154,2283,쌍방울,102280,1027
15100,15385,14708,16614,7808,7467,7080,6292,5274,6821,4542,6652,34293,33680,33268,35648,14497,15667,16371,19093,9.0,4.2,3.9,4.1,5.4,6766,5893,12216,16489,19796,18013,16897,16555,쌍용C&E,003410,1027
37048,36239,29502,24293,5711,4975,5467,4394,9951,9871,12601,13461,22056,20192,17686,18630,15124,16161,18568,19436,-3.0,-2.8,-16.2,-26.6,-14.2,-856,-4253,-9163,-11312,6932,4031,-882,-806,쌍용차,003620,1027
187,256,164,164,237,152,470,605,45,70,14,83,546,615,654,772,125,76,16,90,2.5,8.0,1.1,9.2,6.3,-38,-32,25,69,421,539,638,682,써니전자,004770,1027
323,407,414,472,202,181,225,274,135,162,326,229,430,587,751,795,187,248,424,317,-28.7,-7.5,-8.8,-7.0,-8.1,-241,-154,-200,-269,243,339,327,478,씨아이테크,004920,1027
5022,7994,9691,12034,3867,4267,5472,10729,2258,3138,3322,5727,6064,7356,8807,17739,2879,3658,4371,8271,10.1,1.4,5.2,4.2,4.9,1706,1958,2186,2679,3185,3698,4436,9468,씨에스윈드,112610,1027
1923,2433,2647,3598,831,889,1433,2181,779,851,1313,1840,1395,1465,1928,2720,839,888,1336,1936,-1.2,-10.0,0.3,3.1,5.7,186,160,200,357,556,577,592,784,아남전자,008700,1027
60782,62843,49301,53261,24896,29059,28531,30155,8976,12259,11702,12733,73874,82814,77887,80381,11449,18012,15167,15625,6.8,5.1,3.6,0.3,3.7,25458,26483,26319,27619,62425,64802,62720,64756,아모레G,002790,1027
52778,55801,44322,48631,15672,18031,18257,20185,7632,10666,9659,11575,53711,59890,57019,61167,9247,14902,12375,13724,7.5,6.2,3.9,0.4,3.1,37260,38738,38477,39378,44464,44988,44644,47443,아모레퍼시픽,090430,1027
474,869,490,393,417,355,273,364,292,246,164,256,1071,983,770,850,339,397,236,286,-60.2,-17.9,-24.7,-22.1,-18.1,-1074,-262,-190,-178,732,586,534,564,메타랩스,090370,1027
16276,15424,15271,18465,7009,6715,6580,8007,4075,3670,3637,4828,28403,28844,28875,31153,14564,14234,13599,13991,4.2,4.3,3.3,2.9,6.7,9115,9512,9893,10897,13839,14610,15276,17162,아세아,002030,1026
8438,8368,7875,8926,4056,3775,3469,4109,2263,2340,2194,3041,19287,19308,19014,20373,11428,11250,10778,11177,6.3,1.2,1.5,1.3,5.0,1910,2069,2242,3155,7859,8058,8236,9196,아세아시멘트,183190,1027
7758,6977,7316,9457,2803,2689,2905,3592,1712,1297,1384,1687,8124,8482,8823,9696,2789,2634,2488,2552,0.7,10.0,7.4,6.3,9.8,2531,3046,3530,4346,5335,5848,6335,7144,아세아제지,002310,1027
71834,68868,38781,43397,15136,15608,23862,25653,33693,45584,52472,52393,81911,135034,138515,130827,70979,125951,127621,125616,3.1,-2.3,-7.5,-3.7,-3.8,-662,-8806,-13054,-9817,10932,9083,10894,5211,아시아나항공,020560,1019
29352,29238,28394,31325,8651,8691,8668,8349,6041,6047,6314,6445,10783,10969,11108,11202,6367,6703,6939,7034,1.3,1.9,2.4,2.6,4.0,2571,2580,2569,2329,4416,4266,4169,4168,아이마켓코리아,122900,1016
15968,7706,12004,16084,12712,17017,22685,21247,8105,8525,11568,14997,21827,28838,36215,35098,10749,16102,22315,20529,9.0,11.0,2.9,4.4,3.1,6491,6757,7793,8327,11078,12736,13900,14569,아이에스동서,010780,1027
2720,2524,2604,2746,1517,1421,1929,3195,718,676,536,1317,2900,2372,2180,4114,824,686,541,1456,9.2,8.6,-2.2,6.9,2.9,1264,1149,855,877,2076,1686,1639,2658,HDC랩스,039570,1018
5068,4544,4953,5056,2607,2751,2821,3340,3841,4035,3663,3675,7443,7726,7014,7802,4636,4867,4395,4875,2.8,0.5,-0.9,-4.3,0.3,978,900,755,804,2807,2859,2619,2927,알루코,001780,1027
10314,10170,9089,15701,3028,2981,2962,6048,1474,1212,1261,4819,4985,4928,5322,12450,1565,1328,1409,5558,15.0,11.0,6.1,8.7,8.7,2207,2377,2700,3328,3420,3600,3913,6892,애경케미칼,161000,1027
4457,3636,2337,2018,1082,834,716,718,855,656,596,575,1554,1320,1129,1329,960,779,677,665,1.3,0.7,-2.6,-7.3,8.2,114,66,-22,79,594,541,452,664,에넥스,011090,1027
15986,22622,25050,30011,8877,13992,14404,16013,5397,7294,7741,8985,17304,22736,23390,25675,7076,8949,9138,10490,6.2,1.5,4.4,2.8,3.9,8675,9120,9722,10364,10228,13787,14252,15185,에스엘,005850,1027
20183,21515,22233,23125,6615,7332,7977,8644,3061,3841,4129,4173,16829,17950,19067,19730,4205,4674,5225,5301,9.4,6.3,8.4,7.7,6.7,12030,12676,13240,13786,12624,13276,13842,14429,에스원,012750,1026
2508,2401,725,757,1453,1564,204,769,1774,1461,451,659,3670,3739,686,1164,2218,2186,489,719,-3.7,-3.2,-1.2,-0.5,-8.6,-421,-418,-279,-351,1452,1553,197,445,에쓰씨엔지니어링,023960,1018
3455,4222,3075,2001,2648,2004,1383,1224,653,967,665,639,3881,4337,2548,2084,693,1769,980,850,2.7,-3.1,-2.4,-28.4,-20.4,1363,1259,369,15,3188,2568,1568,1234,에이블씨엔씨,078520,1027
454,509,533,565,873,2135,3365,3535,620,108,87,94,2171,3653,6153,6146,666,176,170,174,-11.8,-0.7,-1.2,3.9,1.5,-333,-418,-301,-211,1505,3477,5983,5972,에이프로젠제약,003060,1027
17151,17012,24162,23088,15764,20879,24444,24526,4731,4498,5093,6634,29413,33464,40812,45819,5623,8342,9365,14307,15.1,13.0,11.4,15.8,9.1,21638,23821,28568,30715,23790,25122,31447,31512,엔씨소프트,036570,1026
1084,737,694,691,722,490,709,717,759,508,447,267,2055,1469,1402,1307,846,544,507,280,-2.7,-13.1,-15.1,0.0,8.2,-249,-487,-483,-371,1209,925,895,1027,엔케이,085310,1027
65,88,341,408,226,266,400,1139,20,8,57,768,452,427,690,1295,26,14,69,778,-11.3,-26.0,-7.5,6.5,-18.2,-364,-397,-361,-179,426,413,621,517,플레이그램,009810,1016
1439,1312,1074,997,739,763,731,762,322,336,271,246,1761,1808,1747,1799,326,341,272,247,16.4,3.2,2.7,1.5,2.0,1284,1312,1326,1354,1435,1467,1475,1552,영보화학,014440,1027
21013,23883,24664,27925,13371,15009,16846,20448,4694,6229,5950,5252,26389,31045,30383,35476,9758,11356,10443,11134,4.1,4.5,6.1,5.9,10.2,9799,11303,13569,16330,16631,19689,19940,24342,영원무역,111770,1016
25187,27380,28510,32405,16704,18634,21501,26196,5243,6712,6488,5958,32622,37894,37325,43256,10820,12137,11154,11705,4.2,5.1,6.5,6.2,11.1,8274,9388,11220,13289,21802,25757,26171,31551,영원무역홀딩스,009970,1021
29714,30841,31834,35821,13751,14648,15784,18467,7100,6685,7892,10108,47216,48327,50009,55210,12142,11342,12887,16187,6.1,1.0,4.3,1.7,3.2,30158,32300,33431,34600,35074,36985,37122,39023,영풍,000670,1027
1112,997,982,1206,821,541,730,855,260,170,175,194,1390,1395,2021,2096,278,198,756,776,3.1,10.7,6.7,5.0,3.1,843,926,1007,1062,1112,1197,1265,1320,영풍제지,006740,1027
1965,1975,1997,4086,1050,1449,1214,2422,900,979,1351,2274,2930,3109,3377,5190,1266,1445,1911,3210,-1.4,-1.8,0.4,-7.0,2.3,1122,1123,901,964,1664,1664,1466,1980,영흥,012160,1027
10954,11082,11014,12667,5063,6924,8785,5550,4329,4500,5400,4222,14646,15443,15641,14230,8647,9353,10428,8894,2.0,-2.5,1.5,-5.0,1.8,5158,5270,4520,4638,5999,6090,5213,5336,예스코홀딩스,015360,1021
22468,23597,25959,27390,8226,6698,7799,10281,5217,5248,5702,7013,20635,21521,23393,26058,7878,8056,8974,10674,8.0,8.5,4.7,4.9,5.3,12602,13312,14119,15164,12757,13465,14419,15384,오뚜기,007310,1027
304,372,520,452,323,237,291,398,149,135,152,221,841,759,715,821,214,234,230,293,-9.1,-22.0,-16.0,-21.2,5.9,-613,-75,-197,-162,627,525,485,528,오리엔트바이오,002630,1027
19977,21036,22805,24151,8032,7608,9425,13008,5430,4954,4382,6410,43421,43663,44976,49618,11655,10287,10028,10909,41.2,2.7,3.6,4.9,4.8,2666,2914,3457,4055,31766,33376,34948,38709,오리온홀딩스,001800,1021
739,523,604,1216,716,724,299,1218,342,328,417,1018,1112,1198,709,1368,348,442,514,1035,-11.9,-16.5,-14.3,-71.1,-18.9,-618,-780,-1454,-1627,764,756,195,333,웰바이오텍,010600,1016
1814,1294,1274,2363,1040,1088,1671,1009,1871,2233,3467,2014,8128,8499,9119,8415,3986,4542,5341,4552,1.9,1.2,-1.7,-2.0,1.0,1546,1369,1193,1275,4142,3957,3778,3863,용평리조트,070960,1026
891,951,966,1099,810,506,749,774,330,303,377,711,982,1000,1355,2203,413,438,520,934,6.7,5.4,0.2,7.8,18.2,123,107,203,530,569,562,835,1269,팜젠사이언스,004720,1027
336,562,66,186,543,456,345,824,425,332,588,533,614,698,1383,1763,429,339,622,569,-8.9,-24.7,-7.3,10.8,5.0,-323,-371,-259,-181,185,359,761,1194,우리들휴브레인,118000,1016
2893,3408,3886,4805,1392,2012,1784,1976,966,1466,1232,1521,2822,3359,3135,3446,1230,1627,1361,1724,0.4,-1.6,3.8,1.8,-1.8,1506,1633,1671,1618,1592,1732,1774,1722,우성,006980,1027
3030,2890,2407,2623,1567,1698,1836,1782,1589,1670,1898,1945,2972,3167,3245,3096,1867,1983,2243,2204,-0.3,-1.4,1.7,-4.4,-4.1,714,942,778,658,1105,1184,1002,892,우신시스템,017370,1027
939,889,892,1076,615,756,699,995,380,311,532,282,2110,1999,2402,2298,800,671,738,702,-8.4,-3.6,-6.8,15.4,-2.6,343,224,546,448,1310,1328,1664,1596,우진,105840,1027
1719,1818,2050,2340,1196,1091,1167,1266,1018,1651,1659,1608,2877,2678,2676,2764,2210,2152,2068,1942,0.2,-4.5,-4.9,2.9,8.3,470,330,410,625,667,526,608,822,우진플라임,049800,1027
2787,8199,8862,9799,4863,25758,5540,4966,4977,25576,7621,5885,7599,29016,10870,10660,5342,26366,8979,8455,0.8,-12.6,-13.0,-1.3,3.2,847,-852,-1122,-886,2257,2650,1891,2205,웅진,016880,1021
6429,6522,6461,8139,4705,22362,4466,4612,3218,19632,2861,3701,6533,24536,6661,7716,3343,19818,2914,3981,4.8,3.8,-9.7,0.0,6.2,1248,936,2052,2372,3190,4718,3747,3735,웅진씽크빅,095720,1026
789,791,684,797,681,776,986,914,273,301,315,267,1500,1631,1773,1703,374,468,439,348,3.8,0.3,2.8,10.8,1.6,645,674,829,829,1126,1163,1334,1355,원림,005820,1027
2777,2696,2396,2765,2008,1658,1802,1956,1499,1605,1630,1658,3048,2810,2848,2941,1728,1792,1857,1834,0.2,-2.2,-12.5,-0.9,-3.0,25,-339,-360,-439,1320,1018,991,1107,윌비스,008600,1016
8140,8752,8905,10973,4402,4308,4910,6708,3075,2371,2606,2871,11119,10763,11208,13477,4564,3675,3388,3546,3.8,3.2,6.2,7.0,14.8,6512,7115,7758,9286,6555,7088,7820,9931,유니드,014830,1027
2089,2101,1892,2159,1108,1294,1298,1338,1248,1306,1173,1246,3066,3252,3544,3662,1593,1824,1784,1825,0.7,-18.0,-4.0,4.5,2.9,997,810,944,1016,1473,1428,1760,1837,유니온,000910,1027
1123,1068,935,1183,667,800,841,872,495,542,617,667,1443,1749,1845,1867,657,888,1013,1028,-0.6,-6.2,1.4,-0.8,0.3,362,351,314,318,786,861,832,839,유니온머티리얼,047400,1027
836,1088,1262,1233,713,885,975,998,539,596,892,1282,1186,1697,2858,3359,557,810,1822,2079,7.4,11.1,11.2,4.9,1.1,107,257,349,368,629,887,1036,1280,유니켐,011330,1027
2656,3353,4028,5910,1859,1913,2148,2717,1133,1275,1367,1701,3241,3497,3800,4903,1325,1353,1433,1818,3.2,3.6,6.7,5.6,13.9,1626,1850,2048,2640,1916,2144,2367,3085,유니퀘스트,077500,1016
2466,2596,2415,2764,1946,2115,1985,1768,391,440,725,519,3756,3964,4113,4100,852,905,1162,1049,1.8,1.8,4.9,-0.7,2.5,2371,2498,2402,2444,2904,3059,2951,3051,유성기업,002920,1027
3843,3661,3348,5037,2393,4444,3125,3088,822,1687,992,739,5411,5220,4982,5017,2095,1934,1099,937,4.5,4.8,-0.5,12.3,7.8,303,337,2216,2335,3316,3286,3883,4080,유수홀딩스,000700,1026
911,1083,1074,1015,755,613,769,806,769,805,792,281,1942,1948,1132,1185,867,922,813,309,2.7,-15.1,-11.1,-28.0,-8.3,-206,-406,-802,-899,1075,1026,319,876,와이투솔루션,011690,1027
335,266,271,297,331,290,323,419,101,89,92,69,512,462,486,617,102,108,131,95,-12.1,3.6,-10.6,-2.4,26.5,236,186,180,319,410,354,355,522,유엔젤,072130,1026
831,909,981,1157,689,651,645,989,278,425,184,300,1352,1377,1549,1930,484,472,379,643,3.7,3.4,4.1,1.7,-0.5,397,427,419,365,868,905,1170,1287,유유제약,000220,1027
15188,14804,16199,16878,11110,11170,11955,12241,3497,3522,3822,4320,21738,21172,23935,24638,5221,4672,5470,5279,5.3,2.7,1.7,8.4,4.1,15354,15454,16913,18003,16517,16500,18465,19359,유한양행,000100,1027
4898,5066,5207,5387,2071,2084,2194,2691,1959,1299,1598,1696,6142,6065,6133,6667,2780,2645,2657,3207,4.9,2.5,3.0,3.3,1.3,3118,3177,3236,3216,3362,3420,3476,3460,율촌화학,008730,1027
3396,2797,2569,2768,1166,998,840,1166,1666,1542,1189,1504,4342,4226,3832,4193,2537,2441,2107,2295,1.2,1.5,0.2,0.4,2.9,1185,1172,1168,1253,1805,1785,1725,1898,이건산업,008250,1027
12392,12743,12211,15020,15757,15713,15796,17385,9340,10630,10518,11819,17409,20755,20440,22016,9991,12945,12600,13668,4.6,5.5,5.0,4.1,4.1,6149,6551,6885,7113,7418,7810,7840,8348,이노션,214320,1026
170491,190629,220330,249327,22856,36499,40630,51884,49983,54063,59882,98170,167539,210948,223404,312421,78964,108880,118438,188418,4.0,2.9,1.2,1.7,5.9,27727,27943,30711,45780,88575,102068,104966,124003,이마트,139480,1016
5603,5142,3932,4696,2688,2247,2243,3103,2683,3026,2950,2982,5056,4167,3894,4497,3279,3407,3243,3242,-2.9,-1.5,-19.8,-3.4,-0.9,1168,168,7,-54,1777,760,651,1255,이수페타시스,007660,1027
15311,15137,13133,17033,4653,5574,5129,6686,4150,4771,5082,5218,9357,10604,9691,11689,5332,6843,6832,7771,-0.1,-0.2,-2.2,-14.1,9.0,605,316,-594,-232,4025,3761,2859,3918,이수화학,005950,1027
1213,1410,1652,2224,346,1224,999,1776,57,647,646,2516,800,2053,2259,5193,61,673,786,2616,1.0,-7.5,0.3,-10.4,1.6,-62,-94,-206,-205,739,1380,1473,2577,이아이디,093230,1016
398,404,274,554,380,442,196,487,517,380,272,291,913,1173,906,1028,528,714,351,304,-32.0,-11.7,-32.9,-13.6,-20.2,-186,-565,-703,-901,385,459,555,724,이엔플러스,074610,1027
1230,1316,1300,1428,2244,1303,1178,1648,425,330,488,475,3032,2735,3176,4780,778,522,875,2327,5.2,0.5,1.7,1.3,1.4,2063,2030,2002,2023,2254,2213,2301,2453,이연제약,102460,1027
691,617,511,578,457,427,800,547,509,899,1018,337,2875,2827,2834,2748,1046,1048,1089,413,-1.1,-0.6,-1.7,-1.3,21.2,525,479,455,925,1829,1779,1745,2335,이화산업,000760,1016
1976,2025,1528,1487,948,835,770,722,666,672,809,718,1381,1494,1386,1253,718,867,975,873,0.5,0.2,-2.3,-15.1,-15.2,6,-30,-245,-441,663,627,411,380,인디에프,014990,1027
586,758,578,717,280,206,260,369,140,128,264,425,574,509,762,1094,266,250,331,435,-1.0,-15.7,-44.7,14.3,5.5,-501,-730,-637,-584,308,259,431,659,인스코비,006490,1020
5041,4942,4587,4849,1759,1722,1724,1850,2173,2302,2253,2464,4554,5079,5113,5434,2576,3204,3242,3468,-0.2,0.2,-1.6,-0.5,0.5,1821,1763,1729,1758,1978,1875,1871,1966,인지컨트롤스,023800,1027
5844,5735,5045,5042,1709,1705,1470,1664,960,928,587,872,3478,3653,3402,3606,1677,1803,1485,1692,3.7,4.4,3.0,3.2,1.1,1371,1420,1488,1485,1801,1850,1917,1914,인천도시가스,034590,1017
4924,4782,4583,5889,1791,1549,1794,1805,1744,1477,1147,1538,4701,4200,3860,3886,2468,2398,1968,1817,1.2,-2.9,-9.9,1.1,3.6,660,391,454,657,2233,1802,1892,2069,인터지스,129260,1019
3504,3608,3842,4393,1245,1279,1489,1578,1376,1536,1693,1846,2844,2943,3198,3540,1666,1844,2053,2329,-0.9,0.8,-1.7,1.9,1.6,993,909,927,938,1178,1099,1145,1211,인팩,023810,1027
5039,5175,5618,5601,2105,2334,2332,3016,1629,2118,1850,3641,5647,6127,6053,7090,2878,3598,3507,5484,3.6,2.3,-2.3,-2.1,-15.4,174,-49,149,-820,2769,2529,2546,1606,일동제약,249420,1027
471,2922,5965,5924,549,2633,2914,3676,817,3244,3411,5393,2655,8097,8110,9208,1005,4859,5054,7374,-0.2,-1.4,-6.9,-3.9,-15.6,326,73,-106,-815,1650,3238,3056,1834,일동홀딩스,000230,1027
3640,3758,3410,4162,2121,2382,1263,2124,1789,2158,1412,1637,3087,3509,2985,3793,2187,2598,2082,2699,-4.1,0.8,0.6,0.9,1.7,124,135,148,193,900,911,903,1094,일성건설,013360,1018
5039,4962,4649,6010,3583,3838,4547,4853,1192,1315,1554,1794,9373,9536,9642,10440,2141,2304,2346,2497,1.9,2.4,0.8,1.1,6.4,6845,6867,6982,7582,7232,7232,7296,7943,일신방직,003200,1027
3000,3246,3433,3713,1614,1714,1625,2036,1837,1803,1771,1982,4323,4375,4391,4943,2224,2147,1942,2225,3.0,0.8,4.5,4.9,5.6,-10,210,314,435,2099,2228,2449,2718,일양약품,007570,1027
480,398,313,318,407,315,228,187,242,230,107,198,683,605,468,413,254,310,212,228,-8.4,-10.1,-21.1,-7.9,-16.9,315,180,139,64,429,295,256,185,일정실업,008500,1027
1340,1644,1687,1877,966,1758,1473,5259,440,479,369,729,1599,2498,2477,6418,566,648,592,1067,4.9,4.9,6.4,2.9,2.4,882,961,979,1011,1033,1850,1885,5351,일진다이아,081000,1027
2064,957,669,1014,640,306,194,302,682,673,766,796,1583,1262,1139,1175,773,759,855,1067,10.9,1.0,-21.4,-30.9,-37.8,749,442,71,-365,810,503,284,108,일진디스플,020760,1027
5020,5502,5369,6889,3575,5927,5189,9594,1090,1010,1086,1486,6922,10369,10810,17536,1638,2215,2274,4043,8.1,6.2,5.4,4.0,4.5,1098,1638,2030,2570,5284,8154,8536,13493,일진머티리얼즈,020150,1027
7314,6683,7079,9324,2953,3041,3057,3586,3709,2731,2776,3671,7786,7809,7904,8379,4783,4771,4815,5149,-0.3,-1.9,0.5,0.6,1.8,1271,1302,1358,1493,3003,3038,3089,3230,일진전기,103590,1027
9294,8962,9340,11901,4598,5303,4913,9302,5078,3925,3782,5325,11166,11886,11585,16116,6691,6721,6390,7268,-1.9,0.1,1.9,1.4,2.4,1292,1377,1294,2247,4475,5165,5195,8848,일진홀딩스,015860,1021
2141,2026,1464,1402,3907,3911,3687,3583,519,574,389,337,5356,5394,5081,4947,608,637,398,362,7.6,3.4,1.4,-0.7,-1.4,1388,1310,1154,964,4748,4757,4683,4585,잇츠한불,226320,1027
3583,3630,3007,3479,1962,1796,1978,2243,733,672,665,1372,3522,3485,3560,4379,752,699,835,1392,5.6,-0.3,-0.1,-1.8,5.4,2516,2479,2443,2647,2770,2786,2725,2987,자화전자,033240,1027
1493,1375,1052,1337,640,407,2212,2807,2027,2057,2118,2147,3640,3866,3734,3833,2390,2553,2331,2393,-2.9,-6.0,-10.7,1.6,0.0,-109,-425,59,63,1250,1313,1403,1440,전방,000950,1027
2056,2531,4028,9870,1243,1157,3010,3596,329,376,3236,3014,1895,2016,5044,5523,342,447,3537,3504,3.0,3.1,4.2,0.7,9.1,831,843,814,1235,1553,1569,1507,2019,제이에스코퍼레이션,194370,1027
1320,526,305,205,1371,549,179,267,413,682,269,191,2149,1239,879,799,883,706,281,197,20.4,-0.8,-52.7,-20.8,-47.5,377,-466,-684,-1070,1266,533,598,602,제이준코스메틱,025620,1027
34779,34217,27479,33257,18016,17699,17423,20186,11657,10982,10639,12242,21721,22528,22425,25421,12793,12960,12269,14148,5.9,6.0,6.3,7.0,7.0,11429,11958,12716,13453,8928,9568,10156,11273,제일기획,030000,1026
822,811,732,797,536,542,518,539,178,142,89,86,1015,1025,987,1065,222,185,128,136,4.1,5.2,6.3,3.3,5.9,806,849,870,907,793,840,859,929,제일연마,001560,1027
1427,7318,7620,7626,3379,3136,3351,3351,2810,3138,3273,2980,9201,8453,8874,8924,3305,3634,3881,3921,141.5,1.3,-10.8,1.7,-1.5,2612,1646,1758,1722,5896,4819,4993,5003,제일파마홀딩스,002620,1026
12594,13840,3770,2731,4782,4557,3004,3906,4032,5567,4589,4883,10316,14675,11686,12668,6492,11424,9518,10827,11.1,7.7,-2.7,-23.3,-22.4,1627,1058,-1971,-3115,3824,3251,2168,1841,제주항공,089590,1019
2095,2034,2013,2385,1032,984,935,1089,936,941,966,915,3036,3125,3500,3470,1296,1398,1476,1725,1.7,-1.4,-0.8,1.4,-7.0,1636,1621,1662,1392,1740,1727,2024,1745,조광페인트,004910,1027
7892,7572,7052,7463,3695,3658,4507,4156,2866,2804,4052,4482,10306,10691,12463,13493,3369,3657,5136,5607,2.3,5.7,3.1,3.4,2.6,5011,5180,5377,5600,6937,7034,7327,7886,조선내화,000480,1027
9562,10793,13030,13436,3903,4711,6001,6671,2045,2771,3206,3202,7115,8014,9463,10467,2806,3264,3947,4809,8.2,6.0,7.0,10.4,4.3,1426,1890,2722,3021,4309,4750,5516,5658,종근당,185750,1027
1245,1372,1246,1422,783,800,884,1043,236,450,461,443,1845,2333,2835,2985,369,749,1147,1370,4.5,4.4,5.9,2.4,-2.3,1092,1200,1259,1189,1476,1584,1688,1615,종근당바이오,063160,1027
5311,7206,8581,9260,2887,3358,3944,4369,1433,2395,2804,3177,8714,10747,12585,13676,2007,3347,4182,5277,8.8,6.3,8.2,9.7,2.0,2404,2812,3548,3644,6707,7400,8403,8399,종근당홀딩스,001630,1027
443,419,627,882,323,398,414,478,103,114,124,84,607,618,576,597,160,190,199,144,-11.7,-8.8,-7.8,-5.0,5.3,-145,-191,-218,-188,447,428,377,453,주연테크,044380,1027
4572,4775,4458,5313,2088,2149,2254,2592,1646,1730,1836,2224,4752,4869,4885,5225,2441,2532,2604,2738,2.5,-0.2,0.4,-1.6,2.1,2031,2052,1995,2141,2311,2337,2281,2487,지엠비코리아,013870,1027
24873,23679,20989,25368,6420,5905,5839,7115,9591,9150,9209,15147,56580,58926,60731,65174,40978,43632,42694,46942,1.3,-4.0,-0.4,0.5,0.3,13907,13610,13848,13979,15602,15294,18037,18232,지역난방공사,071320,1017
796,783,707,731,144,181,139,93,200,383,487,102,637,738,636,478,369,545,541,155,-9.5,4.8,-16.3,-16.1,-29.8,-117,-242,-341,-504,268,193,95,323,지코,010580,1027
5382,5421,3756,4585,5949,4623,4891,5162,4915,3538,3772,3943,6328,5037,5304,5649,5024,3608,3850,4037,2.1,2.5,2.7,1.8,3.2,684,799,844,979,1304,1429,1454,1612,지투알,035000,1026
1201,779,545,590,1036,889,739,816,547,434,302,346,1607,1451,1285,1364,560,450,314,358,6.2,3.5,-1.8,-1.3,2.7,287,235,205,242,1047,1001,971,1006,진도,088790,1016
594,618,643,764,198,239,319,308,126,106,202,204,507,545,707,779,153,135,273,304,3.6,4.9,13.0,8.2,8.3,251,306,335,371,354,410,434,475,진양산업,003780,1027
301,351,371,531,71,83,98,124,130,73,82,98,350,434,448,481,160,168,179,186,1.5,2.7,19.3,3.7,8.2,116,192,195,220,190,266,269,295,진양폴리,010640,1027
2418,2253,2115,2248,1553,1298,1393,1650,1023,932,1014,1145,4962,5139,5480,5661,1371,1413,1593,1760,3.2,0.9,4.5,5.7,2.7,1559,1627,1801,1806,3591,3726,3887,3901,진양홀딩스,100250,1027
343,412,415,387,382,366,1088,1332,188,227,367,345,493,512,1366,2495,199,271,381,440,-42.6,-25.1,-15.2,-19.9,-8.3,-537,-623,-816,-993,294,241,985,2055,진원생명과학,011000,1027
2067,1125,1687,1506,2086,1677,4683,4219,1098,850,947,774,7697,7154,7506,6991,6853,6363,6638,6135,2.0,1.9,-2.2,0.9,-0.2,-179,-378,-331,-355,844,791,868,856,참엔지니어링,009310,1027
360,412,292,182,378,176,74,104,420,345,108,85,725,511,207,324,482,440,116,103,-8.0,2.2,-26.6,-32.6,-24.8,-237,-396,-230,-295,243,71,91,221,센트럴인사이트,012600,1027
556,502,429,142,221,180,204,173,453,358,303,299,886,819,812,767,619,591,479,462,-2.1,-4.1,-4.9,-2.8,-6.5,-23,-63,-84,-110,267,228,333,305,체시스,033250,1027
24170,30701,41568,61367,28590,28297,44629,81022,19093,21338,26276,52461,79595,87373,119540,227796,23324,29971,45262,91896,2.1,0.2,-4.1,1.7,9.5,4534,1482,3163,17096,56271,57402,74278,135900,카카오,035720,1026
5261,5119,5764,5538,2748,3304,4349,4025,1054,1027,1273,1153,5744,6805,8734,9645,1581,1732,2144,2172,20.0,44.7,9.1,7.4,6.9,3821,4280,4948,5430,4163,5073,6590,7473,케이씨,029460,1027
5358,5434,9021,14242,2328,2257,4899,6162,872,614,3158,3336,5005,4797,9217,10646,1127,884,3554,4126,5.5,-5.3,0.4,-1.7,7.3,2214,2294,2378,2965,3878,3913,5663,6520,코리아써키트,007810,1027
12597,13307,13829,15915,5958,6183,6226,7922,6504,7164,7181,7877,10615,12044,11890,14119,8197,8879,9171,9465,1.9,2.1,1.6,-2.4,2.6,1348,1615,1738,2481,2418,3165,2719,4654,코스맥스,192820,1027
4383,4684,5259,5760,2068,2353,2466,2740,4096,4375,4243,4228,8798,8927,8816,9547,5200,5367,5493,6128,0.8,1.6,-1.6,-1.9,0.5,1017,994,891,1010,3598,3560,3323,3419,코스맥스비티아이,044820,1021
6781,4068,3555,5126,1254,1518,2037,1992,2010,1795,2640,2552,4930,5170,6685,6813,3305,2858,4185,3785,5.9,-1.9,-2.9,-2.6,3.5,-1013,-498,-290,-207,1625,2312,2500,3028,코스모화학,005420,1027
1086,1129,982,1108,384,358,298,339,517,466,447,556,785,773,732,793,551,520,492,603,-0.7,-0.2,2.7,-2.3,-6.9,-1,21,9,-42,234,253,240,190,코아스,071950,1027
43245,42844,48902,54104,12555,13203,13520,14228,19318,20913,22101,20468,34739,36186,37081,39663,26447,28967,28491,29149,2.8,-0.1,-0.6,4.6,4.4,2220,1869,3217,4551,8292,7219,8590,10514,코오롱,002020,1021
33583,34841,39282,47495,9485,9939,11159,11705,12579,12858,15388,14282,20334,22054,24699,25757,15867,17504,19836,19624,0.7,0.7,1.6,3.4,5.4,1898,2130,2787,4083,4467,4550,4863,6133,코오롱글로벌,003070,1018
44598,44072,39703,46621,19552,20791,18700,22132,23244,22450,21544,22324,55729,52931,50437,56013,33643,31668,27516,30507,2.3,0.8,0.4,4.0,3.8,9888,10131,11885,13545,22086,21263,22921,25506,코오롱인더,120110,1027
3213,3303,2952,4053,1208,1185,1079,1709,991,931,697,1181,3410,3387,3179,3691,1436,1411,1197,1485,5.3,3.5,1.6,0.9,6.3,755,758,764,986,1974,1976,1982,2206,코오롱플라스틱,138490,1027
27073,30189,32374,36643,8437,7669,8969,11065,12343,15868,14173,12932,23789,28550,30290,38006,12912,17778,15390,18962,15.8,15.4,12.7,13.8,13.6,9668,9540,13652,17573,10877,10772,14900,19044,코웨이,021240,1026
1252,2388,2386,3825,875,1189,1310,2400,330,626,764,1573,1135,1615,1853,3491,366,666,861,1816,0.7,6.0,0.8,-0.5,1.7,281,279,274,374,769,949,992,1675,콤텍시스템,031820,1026
4933,5283,5878,6851,2474,2670,3263,4022,901,948,1194,1366,7470,8126,9251,10709,1376,1389,1642,1842,75.1,13.7,10.2,12.3,14.5,10611,11210,12069,13317,6094,6737,7609,8867,쿠쿠홀딩스,192400,1021
10921,9045,9232,9282,2810,2440,2237,2606,4458,4389,3625,4194,12865,12382,10934,11157,7928,7783,6062,6264,14.1,0.8,-1.8,3.5,1.0,2457,2201,2395,2426,4937,4599,4872,4893,크라운해태홀딩스,005740,1021
181,302,215,216,805,464,173,440,690,637,53,216,1242,568,274,681,719,663,74,229,-35.6,-21.8,-71.3,-14.0,-13.8,-598,-1215,-1281,-114,523,-95,200,452,아센디오,012170,1026
5635,5196,4306,5168,1992,2341,2167,2478,1829,1618,1466,1659,5427,5614,5413,5847,2324,2182,1957,1992,1.3,2.8,4.6,1.6,5.0,1737,1789,1790,1922,3103,3432,3456,3855,태경산업,015890,1027
474,418,471,541,197,511,520,623,91,98,91,105,1232,1356,1407,1607,152,171,165,198,1.5,2.5,7.6,5.6,7.2,665,773,831,932,1080,1185,1242,1409,태경케미컬,006890,1027
31088,22607,17406,25918,20724,19458,16286,21721,7685,5626,3719,5933,45027,43571,40602,49238,9977,8733,6776,9515,4.5,5.8,3.8,3.7,7.1,30119,31435,33082,36839,35050,34838,33826,39723,태광산업,003240,1027
6087,5729,5620,7129,1520,1260,1148,1532,2286,2141,1876,2046,6068,5663,5668,6009,2692,2454,2424,2573,-0.1,4.6,3.7,0.8,3.6,2421,2234,2255,2409,3376,3209,3244,3436,태림포장,011280,1027
4492,4709,4044,4630,2010,1804,1837,1980,2367,2446,2627,2723,3963,3899,4423,4477,2985,3218,3428,3553,-1.1,-1.4,-5.9,-2.3,-2.8,622,343,234,145,978,681,995,924,태양금속,004100,1027
36911,29671,22815,27517,27908,35284,25012,20097,18865,26382,19347,19641,49586,59161,37983,37348,34763,43447,31515,30256,3.0,5.0,1.8,11.0,1.7,9193,10068,15498,16175,14823,15714,6468,7092,태영건설,009410,1018
9721,9716,7850,8929,2947,3122,3448,4071,3455,3665,3681,3251,5565,6133,6760,7650,4055,4290,4987,6001,1.8,1.9,1.9,-1.9,-2.0,550,672,519,396,1510,1843,1773,1649,태평양물산,007980,1027
1085,1126,1188,1549,304,471,661,749,422,178,389,260,1602,1450,1626,1808,671,443,482,495,4.7,3.2,5.0,9.0,11.0,132,208,345,510,931,1007,1144,1313,테이팩스,055490,1027
421,418,364,348,908,705,823,783,122,146,117,111,1258,1274,1231,1222,151,163,131,128,4.5,5.2,3.4,1.5,1.5,1012,1015,1004,998,1107,1111,1100,1094,텔코웨어,078000,1026
1810,1720,1135,1146,1005,1208,780,656,574,904,900,657,2042,2409,1942,2021,987,1423,1270,1068,-2.9,-3.9,-2.6,-18.2,-4.7,514,442,70,9,1055,986,672,953,토니모리,214420,1027
3728,4022,3464,4027,1104,1382,1395,1771,1377,1478,1318,1748,2124,2654,2796,3399,1721,2024,2128,2522,1.5,2.3,7.2,-6.3,5.4,78,217,78,240,403,630,668,877,티에이치엔,019180,1027
7375,8173,2769,2267,3410,2737,1370,1255,1770,2626,2116,2641,4975,8710,7661,8053,2126,6252,6284,7160,15.6,8.5,-7.0,-17.6,-20.8,-170,-432,-1287,-2030,2849,2458,1377,893,티웨이홀딩스,004870,1027
10157,11650,13339,15369,4118,4433,4683,6138,4860,6321,5909,7606,8832,9792,9893,11076,5733,6793,6822,7937,5.7,0.4,-0.9,1.2,0.2,2272,2153,2224,2238,3099,2999,3071,3139,팜스코,036580,1027
26684,24679,24972,46161,6922,6795,6625,13587,6705,7091,6043,11494,41195,44542,46593,64888,14591,15546,18527,28919,3.4,3.7,3.5,2.0,9.9,852,2360,3286,8513,26604,28996,28066,35969,팬오션,028670,1019
4123,2656,4841,4353,3377,3729,2490,2411,4218,3354,2914,1957,5884,6279,5089,4972,5606,6148,4808,4518,-17.8,-6.1,-4.6,0.0,1.8,-1638,-1762,-1212,-1122,278,131,281,454,페이퍼코리아,001020,1027
3358,3533,3386,4241,934,1039,1152,1229,1397,1369,1475,1410,1784,1942,2032,2201,1562,1607,1776,1941,-4.6,-24.7,-3.9,-3.9,0.1,-479,-549,-628,-624,222,335,256,260,평화산업,090080,1027
5560,5811,5211,6277,1970,2047,2741,2646,2876,3485,3588,3467,4954,5029,5223,5181,3562,3789,4031,4170,-1.1,-12.7,-4.4,-1.7,-3.0,495,333,283,27,1392,1240,1192,1011,평화홀딩스,010770,1027
9403,9167,9073,13473,2519,3078,3054,4323,1964,2519,2303,2614,4542,5034,4854,5864,2355,2823,2581,2640,4.2,2.5,0.5,1.4,18.4,1358,1337,1401,2377,2187,2211,2273,3224,포스코스틸리온,058430,1027
251739,244226,214724,339489,59802,50323,47646,71552,54211,35612,33974,56693,98810,89594,83280,107707,69915,59114,51672,72586,1.9,1.2,2.2,2.7,3.7,17323,18575,20082,22925,28895,30480,31608,35121,포스코인터내셔널,047050,1016
22720,23815,23112,25189,4705,4678,6304,7110,5252,6212,7768,8038,12169,14846,16936,19694,7713,10215,11806,13796,2.8,1.0,-0.6,0.7,0.0,2590,2247,2426,2472,4456,4631,5130,5898,풀무원,017810,1027
27745,24513,25936,35095,13616,12452,13020,18595,8398,7633,7473,11088,26681,25625,25520,31483,12888,11787,11056,14626,5.5,2.3,0.7,2.8,8.5,7427,7326,8104,10336,13793,13838,14464,16857,풍산,103140,1027
3061,2644,2659,4878,1796,2417,2341,1964,1016,1680,1981,865,8793,9386,9753,10520,1659,2163,2474,1557,8.6,4.2,2.7,1.4,17.1,4297,4351,4470,5963,7134,7223,7279,8963,풍산홀딩스,005810,1021
1100,1351,1188,1202,1380,1284,1036,1571,1325,1398,1035,1059,3041,4168,3831,5394,1441,1444,1131,1121,2.1,-4.5,-3.2,-11.8,-0.4,313,196,-283,-271,1600,2724,2700,4273,KH 필룩스,033180,1027
8283,6146,1096,403,4977,4082,2083,1662,4136,4075,1733,1725,7161,10076,7033,4306,4762,7897,5779,3728,2.3,1.6,-1.4,-25.6,-12.4,1182,969,-795,465,2399,2179,1254,578,하나투어,039130,1026
1705,2143,1617,2262,807,832,865,926,580,592,849,688,2330,2343,2397,2597,1046,1067,1136,1219,3.4,-3.0,0.0,-0.5,4.6,701,698,683,796,1284,1276,1261,1378,하이스틸,071090,1027
18856,20351,22563,22029,10650,7823,8994,13043,16685,13589,14356,18368,34281,32709,32978,36311,22658,22377,22235,25379,0.4,0.6,-1.3,2.6,2.1,1763,2389,2811,3025,11623,10332,10743,10932,하이트진로,000080,1027
18767,20263,22470,21920,10837,8051,9178,13188,21885,16587,18387,23548,39893,38367,39050,42363,28935,28541,28446,31489,-0.2,0.2,-1.0,2.8,1.7,5735,5268,5856,6101,10958,9826,10604,10874,하이트진로홀딩스,000140,1021
261850,249826,208337,275208,99249,92328,75279,131477,98712,89005,72128,140217,396897,393119,359098,436699,311917,311653,281746,345506,-3.1,1.4,0.2,-0.4,2.4,54979,53977,51908,61853,84980,81466,77352,91193,한국가스공사,036460,1017
5261,5038,3032,3455,2015,2037,2004,1771,478,497,843,396,4244,4647,4254,3839,1053,1417,1528,938,5.7,4.5,3.7,-10.7,0.8,2550,2591,2100,2304,3191,3230,2726,2901,한국공항,005430,1019
2397,2224,2037,2717,678,702,667,1246,311,539,205,666,2046,2093,2028,3579,751,688,586,1041,5.5,3.4,2.1,0.7,2.0,914,940,957,1064,1295,1405,1442,2538,한국내화,010040,1027
7464,7721,8025,9622,4189,3994,4856,5514,1302,1225,1634,1948,8605,8856,9852,11252,1696,1754,2210,2830,5.9,4.6,3.7,6.2,6.0,6577,6817,7327,7882,6909,7102,7642,8422,한국단자,025540,1027
4813,4854,4840,6289,1525,1416,1664,1788,1088,875,1390,1285,3073,2928,3165,3421,1596,1541,1725,1882,3.6,1.5,-2.6,2.1,3.4,1426,1340,1399,1502,1477,1387,1440,1539,한국석유,004090,1027
606276,591729,585693,605748,197451,194830,205619,220508,218415,242317,258812,317322,1852491,1975978,2031421,2111089,1141563,1287081,1324753,1457970,0.8,-0.6,-1.2,1.0,-2.5,515191,492021,511336,452470,710928,688897,706668,653119,한국전력,015760,1017
2342,2170,2215,3312,1733,1610,1913,2305,855,1004,956,1127,3908,3899,4122,4636,1267,1476,2047,1537,1.2,0.3,-6.1,-8.7,6.7,45,-90,-140,90,2641,2423,2075,3099,한국전자홀딩스,006200,1021
4174,4372,3283,5102,1752,1746,1873,2277,763,686,656,627,3520,3567,3575,4231,831,786,731,762,3.3,2.1,4.0,2.9,16.9,1569,1651,1719,2333,2689,2781,2844,3469,한국주철관,000970,1027
2267,2734,4117,3678,1901,2213,2563,2478,475,667,753,940,3601,3976,4783,4984,564,849,978,1094,0.2,-0.8,4.7,13.1,2.9,2186,2275,2786,2847,3037,3127,3805,3890,한국카본,017960,1027
13579,13789,13221,15863,5552,6460,7752,8829,5173,7074,6868,8886,21864,24003,24896,26060,13766,15524,14904,12465,8.4,2.6,1.5,6.6,1.7,2132,2323,3824,4028,8098,8479,9992,13595,한국콜마,161890,1027
5617,4995,6755,6740,2301,3071,4059,3199,2169,3494,3625,3011,8817,10919,12185,12097,3863,4913,4309,3551,7.9,11.1,7.2,13.4,4.8,1711,2062,3152,3295,4954,6006,7876,8546,한국콜마홀딩스,024720,1021
67951,68833,64531,71411,36638,41137,46882,55092,20226,21311,17810,18692,97964,101646,106585,117039,30061,29774,32464,34988,6.3,5.5,4.3,3.7,5.4,39959,43437,46653,51906,67903,71872,74121,82051,한국타이어앤테크놀로지,161390,1027
8480,8476,8192,9633,5904,5244,5989,6303,1969,1351,2029,2420,34986,36071,37925,40812,2627,2285,2920,3458,7.6,6.4,4.6,4.9,5.1,18843,20086,21515,23025,32359,33786,35005,37354,한국앤컴퍼니,000240,1021
7937,9540,8816,10039,3433,3703,3851,4017,3983,3600,3725,4065,6406,6523,6680,6994,4202,4241,4310,4368,-3.6,-0.2,1.7,1.7,2.9,1566,1639,1728,1926,2204,2282,2370,2626,한국프랜지,010100,1027
27860,31102,28251,25623,24095,26548,31523,36810,16678,22029,26234,28001,37559,43671,51591,58552,27030,31840,39248,45578,-7.6,1.6,4.1,1.5,1.0,4160,5483,6009,6748,10529,11831,12343,12974,한국항공우주,047810,1027
1539,1312,725,670,619,476,470,300,375,378,404,235,950,813,754,485,422,461,459,265,4.1,-8.0,-19.5,-9.8,-11.8,270,94,23,-45,528,352,295,220,한국화장품,123690,1016
4467,4730,5036,5176,2838,3096,3282,3255,2575,2679,2277,2778,6526,7487,8189,8416,3392,4047,4371,4576,0.6,1.1,4.8,3.4,0.4,2371,2604,2847,2889,3134,3440,3818,3840,한독,002390,1027
12997,13049,15509,14753,10295,6871,7867,7943,12716,9861,8753,6541,17938,15882,16536,15214,15281,13271,12794,11048,2.2,-0.6,0.2,6.8,6.3,-1374,-1298,-217,211,2657,2611,3742,4166,한라,014790,1018
8865,7984,7358,10412,3685,3223,3721,4758,2903,4945,4721,5227,17241,17604,19615,22950,8589,8743,10746,12805,2.3,0.7,2.4,2.4,5.0,6392,6430,6649,7444,8652,8861,8869,10145,한라홀딩스,060980,1021
2077,2947,2326,2701,1539,1332,1344,1375,1000,482,791,1016,2097,2036,2187,2853,1064,795,899,1411,6.1,3.8,11.3,4.9,6.4,637,833,904,1009,1033,1241,1288,1442,한미글로벌,053690,1026
2171,1204,2574,3732,1134,1295,2089,2498,293,318,676,807,2460,2575,3270,4293,305,378,699,825,3.3,18.6,7.7,17.2,27.6,2039,2089,2152,2826,2155,2197,2571,3468,한미반도체,042700,1027
7080,8166,8574,9502,2445,2171,2157,2226,2272,2282,2201,2210,9165,9108,9232,9499,2635,2651,2645,2596,3.2,1.9,3.4,2.5,4.6,3429,3559,3679,3971,6530,6457,6587,6903,한미사이언스,008930,1021
10160,11137,10759,12032,5641,6622,6144,7040,4350,4718,5335,6489,16912,19137,18820,19367,9020,10914,10501,10085,4.2,2.0,3.5,0.9,4.3,2878,3238,3341,3969,7892,8223,8319,9282,한미약품,128940,1027
19285,16984,20675,22312,4398,4787,5209,4575,2999,4073,4395,3917,9402,12026,12295,12464,3657,5893,6006,6247,10.2,9.4,4.0,5.5,4.6,6679,6945,7383,7748,5745,6133,6289,6217,한샘,009240,1016
12992,12598,11959,13874,6811,7198,8197,8818,2283,2180,2309,2463,12727,13236,14385,15571,2820,2781,3125,3167,4.7,5.7,6.6,6.2,7.5,8732,9488,10243,11287,9907,10455,11260,12404,한섬,020000,1027
17127,16150,16983,16720,8259,7397,6589,7700,5888,6410,4808,6419,11707,11795,10211,12162,6781,7245,5997,7518,3.7,-4.2,-1.5,2.4,6.0,3669,3501,3699,4206,4926,4550,4214,4644,한세실업,105630,1027
3230,3075,2202,2077,1551,1362,1063,967,561,761,631,777,2056,1847,1497,1291,571,841,718,821,3.4,1.9,-22.4,-13.8,-22.2,1263,801,573,270,1485,1006,779,470,한세엠케이,069640,1016
25215,27367,27979,27989,10753,9943,10465,11225,9036,9469,8801,10266,16783,17314,18400,22413,10606,11355,10942,12919,3.5,-2.7,0.2,4.0,3.7,2431,2537,3115,3369,6177,5959,7458,9494,한세예스24홀딩스,016450,1027
2484,2339,2448,2629,751,876,894,736,507,598,603,534,913,1034,1071,1097,528,624,635,597,2.4,3.7,3.2,2.8,3.3,139,165,188,219,385,410,436,500,한솔PNS,010420,1016
4342,4607,5096,7470,924,991,1208,1783,583,907,1118,1665,1268,1668,1960,2666,705,1197,1413,1880,3.0,1.3,4.0,4.8,10.2,947,847,927,1143,563,471,547,786,한솔로지스틱스,009180,1019
19766,16791,15099,18342,6055,5890,5670,6637,7979,7216,6183,7274,17927,17433,17404,18878,12052,11312,11056,12085,2.7,2.3,2.3,3.4,0.8,956,1213,1634,1601,5875,6121,6348,6793,한솔제지,213500,1027
5819,5443,6193,7687,1565,3067,3077,4113,1650,1943,1716,1997,7917,9392,9992,11972,3445,4186,3769,4293,8.2,8.9,10.5,13.4,14.5,3027,3718,4708,5959,4472,5206,6223,7679,한솔케미칼,014680,1027
8419,9722,11949,14906,2160,2113,3111,4680,2489,1986,2343,3333,5130,4953,5914,7887,3112,2335,3123,5104,3.7,-3.9,1.3,4.8,-1.4,251,409,699,594,2018,2618,2791,2783,한솔테크닉스,004710,1027
6020,3463,3595,4136,2535,2104,1670,1653,5572,1784,926,884,13474,6664,6271,6537,9154,2103,1007,1044,-4.8,-2.8,2.6,11.2,3.7,648,886,1493,4154,4320,4561,5264,5493,한솔홀딩스,004150,1021
2969,2639,2532,2633,843,754,787,982,679,915,761,1018,3081,2958,2950,3147,1464,1416,1404,1548,1.1,3.8,-1.5,0.2,1.8,478,412,417,473,1617,1542,1546,1599,한솔홈데코,025750,1027
21422,16233,15569,13111,11680,9174,10241,12772,9350,7324,7825,8600,17784,16510,17343,21199,13324,11372,11135,14422,4.2,8.8,4.2,6.2,2.3,3195,3830,4873,5333,4460,5138,6208,6777,한신공영,004960,1018
533,528,516,544,652,622,647,693,78,106,95,109,907,940,952,1011,109,130,129,151,5.1,3.7,1.8,3.7,4.2,557,568,593,625,798,810,823,860,한신기계,011700,1027
59376,71542,68728,73514,28592,29224,34647,35517,18671,20915,27184,28135,53558,70824,78074,82337,32241,47449,55680,57571,7.5,6.0,5.2,1.5,3.9,21796,23182,22573,23684,21317,23375,22394,24766,한온시스템,018880,1027
918,1085,886,1016,1284,1343,1294,1188,218,274,231,221,1623,1914,2201,1985,454,510,389,350,4.0,2.0,10.8,9.6,4.3,-213,-31,176,264,1169,1404,1812,1635,한올바이오파마,009420,1027
5659,5774,6153,7763,905,958,1081,1386,1245,1194,1933,2447,1996,2758,3017,3748,1326,2039,2331,3013,4.0,2.7,2.1,-0.7,1.2,594,636,603,633,670,719,686,735,한익스프레스,014130,1019
11867,16518,15334,17670,11777,11161,11278,10384,6193,7443,7326,6773,32542,33000,33201,32638,15294,15576,14967,13337,2.4,15.8,1.5,3.3,2.8,19400,19376,19737,20064,17248,17424,18234,19301,한일홀딩스,003300,1027
1686,1730,1571,2486,687,797,654,1099,975,980,765,891,3122,3194,2951,3387,1508,1703,1463,1610,3.0,-2.6,-3.5,-1.6,8.1,1417,1305,1256,1505,1614,1491,1488,1777,한일철강,002220,1027
12425,12470,13032,13806,6361,7834,7600,8001,2704,2490,2556,2677,12809,13594,13499,14269,2968,2960,2982,3149,11.9,13.0,11.6,6.4,7.1,9762,10551,10434,11036,9841,10634,10517,11120,한전KPS,051600,1018
4337,4486,4317,4331,2814,2576,2379,2564,2484,2235,1873,1836,7715,7352,7003,7055,3101,2430,2012,1921,4.2,1.7,3.5,2.8,2.3,4644,4952,5021,5165,4614,4922,4991,5134,한전기술,052690,1026
2625,2896,3293,3211,889,950,871,881,450,496,537,526,1485,1667,1636,1633,731,814,804,781,9.2,8.0,10.7,8.2,5.2,593,686,670,686,754,853,832,852,한전산업,130660,1026
19508,20623,22157,25041,4404,4176,5779,7022,7830,5162,7552,8659,26614,35484,37887,38776,15943,24945,25507,25037,-1.9,1.8,-0.1,0.3,4.2,5904,5731,5777,7273,10671,10539,12380,13739,한진,002320,1019
16979,16288,16958,17065,17209,13005,10675,9490,21401,18452,10346,9500,27336,24702,21939,23852,34418,22252,18739,19532,-5.9,-37.0,11.8,3.4,-6.1,-20566,-12935,-12180,-13587,-7082,2450,3200,4320,HJ중공업,097230,1018
9460,8776,7952,8880,3577,3535,3336,3795,4868,6253,5502,5581,18736,18607,18372,18378,15066,15002,14806,14892,-7.6,0.0,1.6,-0.2,-0.4,-5021,-4734,-4774,390,3670,3605,3566,3486,한진중공업홀딩스,003480,1017
13049,12035,4088,3953,8543,6667,11983,4058,6521,5994,8886,13071,28501,26937,34886,37547,11261,12730,18243,19305,9.5,-0.5,-9.4,-11.1,-1.0,-3637,-5776,-8402,-7957,17240,14207,16643,18242,한진칼,180640,1019
982,601,253,352,845,467,779,940,665,372,575,895,1062,918,1178,1343,736,651,801,973,4.8,1.5,-1.8,-21.3,-22.4,0,-27,-197,-415,326,267,377,370,한창,005110,1016
487402,504124,509265,528361,137205,152427,149538,176347,148700,160027,156521,164690,1695486,1822862,1911783,2023664,1525955,1640222,1734606,1813191,0.8,0.5,0.1,0.4,1.1,36603,36007,33421,46508,169531,182640,177177,210473,한화,000880,1027
90460,94574,91950,107252,50125,53227,49584,60740,51325,58310,52511,57879,152315,156811,151373,200076,90044,98753,91696,118063,6.1,1.1,-1.6,2.0,3.5,44965,41759,44298,50514,62271,58058,59677,82013,한화솔루션,009830,1027
44532,52641,53214,64151,38770,45636,51227,62835,31441,33290,39004,43301,73967,87084,94648,110458,47609,58531,64751,71143,-0.8,0.8,2.0,1.8,2.9,13731,14759,15812,18120,26358,28553,29897,39315,한화에어로스페이스,012450,1027
3633,3814,4587,6554,1117,1275,1740,2560,649,885,1200,1548,3062,3266,3832,4749,1099,1180,1514,1806,8.8,7.0,5.8,8.5,16.6,894,1017,1250,1875,1963,2086,2318,2943,해성디에스,195870,1027
7254,5393,5639,5677,1753,1499,1247,1201,2689,3087,2056,2525,7950,7569,6212,6549,5074,5127,3575,3951,0.9,0.3,-4.5,4.0,-0.1,1989,1558,1753,1710,2876,2442,2637,2598,해태제과식품,101530,1027
6009,6177,5727,5622,3025,3444,3332,4038,3232,3226,3512,4995,7053,8511,8441,8950,3847,5268,5294,6329,3.5,0.6,0.9,-1.0,-7.4,2167,2210,2100,1524,3206,3243,3147,2621,핸즈코퍼레이션,143210,1027
9108,8351,6894,8598,3811,3586,3409,3876,2612,2171,1558,1886,6004,5473,5249,5829,3181,2638,2322,2752,5.2,1.4,2.3,2.6,1.9,2457,2589,2701,2767,2823,2835,2927,3077,HDC현대EP,089470,1027
167309,172788,169709,180655,133368,131720,133989,145264,68609,67709,64677,76132,180546,182270,179393,196373,97628,95120,91729,102080,1.9,2.9,3.2,1.3,3.0,49864,53252,53008,56400,82918,87150,87664,94293,현대건설,000720,1018
32517,31243,32385,34861,11323,11197,11018,9906,4554,5272,5467,5885,28374,29666,30685,31100,7263,8502,8783,8995,4.9,4.5,2.2,2.7,1.3,11306,11519,12030,12285,21111,21164,21902,22105,현대그린푸드,005440,1016
168656,182701,165199,217796,44581,50543,59501,69682,28848,34135,35477,39430,86878,101297,108987,121709,44277,54595,58323,63585,8.4,5.2,5.3,5.8,6.8,41173,44925,49668,56199,42601,46702,50664,58124,현대글로비스,086280,1019
24119,24593,27853,28725,25732,27092,27783,26798,17295,22920,22303,20907,40022,40843,41974,41072,28942,32014,28512,28389,-1.1,-7.6,-8.8,0.5,1.2,2146,-1566,-1199,-483,11080,8829,13462,12683,현대로템,064350,1027
13517,12376,13846,14066,4426,3977,3638,4306,2122,2481,2588,3205,6789,7528,8033,8636,2315,2949,3223,3746,6.7,5.7,2.7,3.4,1.6,3285,3390,3621,3698,4474,4579,4810,4890,현대리바트,079430,1027
351492,380488,366265,417022,197205,215046,229029,235524,82422,89623,100822,100770,430711,466061,484977,514825,123677,141964,151696,161251,3.7,4.5,5.1,3.2,4.7,300955,316568,328513,346795,307034,324097,333281,353574,현대모비스,012330,1027
24030,29941,27920,28872,18014,17448,18792,20467,10764,10016,11910,16120,34637,33806,35990,38783,11466,10267,12315,16740,5.1,2.1,1.8,-0.4,-4.3,18167,18436,18026,16334,23171,23539,23675,22043,현대미포조선,010620,1027
18622,21990,22732,35724,12588,13653,19859,19453,12932,14434,22762,19785,69886,76231,87070,89692,21595,26438,36747,37436,4.5,4.2,3.3,1.3,2.6,35009,36484,36948,38690,48291,49793,50323,52256,현대백화점,069960,1016
7127,7333,6802,8557,3581,3652,4057,5188,1436,921,1187,1861,6056,6086,6485,7688,2236,2057,2200,2710,3.4,3.3,3.6,3.8,9.9,3051,3264,3507,4194,3820,4029,4285,4978,현대비앤지스틸,004560,1027
15478,16167,39519,47796,9603,10724,58302,64518,6882,9344,33284,39204,34097,42090,96171,106515,13037,18577,52719,58467,6.7,18.7,7.2,2.8,2.3,31458,33921,34851,35704,21060,23513,43452,48048,HDC,012630,1021
47140,42634,28809,37825,8831,8516,6593,11114,7296,6754,4613,8738,10982,14446,12191,17074,7922,11028,9046,13446,1.8,-0.7,1.3,3.7,2.6,4257,4335,4746,5043,3060,3418,3145,3628,현대코퍼레이션,011760,1016
52221,55131,64133,137941,17476,14272,22372,87680,11056,16837,28807,25247,41214,71602,93734,178761,30818,60699,76848,75178,-29.8,-20.5,-10.5,1.5,39.2,-35893,-44771,-44439,7806,10396,10903,16886,103583,HMM,011200,1019
2897,2929,396,1367,3975,4125,4324,4475,472,641,1218,1684,7805,8135,10071,10340,664,720,2126,1763,6.1,5.3,4.7,-4.5,8.3,3673,3948,3582,4431,7141,7415,7945,8577,현대퓨처넷,126560,1026
18772,18725,18212,19734,9011,9860,11923,11315,7450,9346,9298,10824,23748,25477,26262,29874,14436,15996,16008,18512,3.6,0.1,1.8,3.8,4.0,2358,2529,2369,3317,9312,9481,10254,11362,현대엘리베이,017800,1027
78805,73146,65922,75277,38908,35691,39880,41565,18628,18614,19857,21263,71074,67743,77199,77495,40705,36825,41940,40542,-0.9,-0.8,0.8,0.7,0.7,25204,25495,25936,26515,30369,30918,35259,36953,현대위아,011210,1027
207804,205126,180234,228499,87690,95787,99348,127758,67025,64203,60727,74668,333049,343663,348450,370423,162818,171326,181520,187819,2.2,1.2,0.1,-1.3,4.2,115606,114883,109331,123585,170231,172337,166930,182604,현대제철,004020,1027
131610,151826,149037,154934,123167,125460,130014,145622,94103,89419,95115,112865,247299,250554,252442,272931,116189,121291,128230,148793,6.8,-1.7,0.9,-3.3,-4.3,160437,161806,154191,144672,131110,129263,124212,124138,한국조선해양,009540,1027
968126,1057464,1039976,1176106,471435,459047,510903,533128,494384,533141,594595,642368,1806558,1945122,2093442,2339464,1067597,1181465,1330032,1513306,2.6,0.9,1.7,1.0,2.6,664901,682496,689118,731679,738961,763657,763410,826158,현대차,005380,1027
1654,1839,1516,1304,976,1111,864,806,204,403,181,271,1888,2414,2169,2510,205,619,400,488,5.9,1.9,4.5,7.7,5.1,908,964,1095,1176,1683,1795,1769,2022,현대코퍼레이션홀딩스,227840,1016
10177,20604,21264,22099,10132,9341,11062,9753,7679,5378,7474,5443,25627,25038,26931,26003,8782,7748,8983,7180,6.5,7.5,3.3,4.3,3.8,14093,14652,15544,16378,16845,17290,17948,18823,현대홈쇼핑,057050,1016
1546,1479,1353,650,983,937,1076,882,470,424,496,412,1208,1143,1304,1233,574,538,702,617,-4.1,-7.4,-1.0,-0.6,2.2,64,37,29,42,634,605,602,616,형지엘리트,093240,1027
2167,2609,2175,2064,1377,1298,1235,1152,1331,1164,1023,802,2284,2183,2079,1947,1367,1228,1097,928,0.6,-0.3,1.9,2.3,2.4,969,1012,1058,1100,917,955,982,1019,혜인,003010,1016
3133,3098,2925,3449,1912,1810,1675,1944,1440,1198,1225,1328,2875,2923,2721,3027,1610,1678,1649,1826,1.7,1.6,1.0,-6.2,4.1,967,971,778,885,1265,1245,1072,1201,호전실업,111110,1027
47137,57173,31881,37791,12722,17161,11640,10872,10027,14381,7753,10118,23037,35273,28938,26565,15387,26077,22699,20795,1.2,4.9,5.8,-8.8,1.0,4754,6270,3418,2886,7650,9196,6239,5770,호텔신라,008770,1016
4752,4514,4193,4222,4484,4583,3945,6152,1572,1759,1364,2236,6409,6126,5805,8080,2661,2416,1860,3910,8.3,8.1,1.2,5.5,4.3,2748,2707,2958,3209,3748,3710,3945,4170,화성산업,002460,1018
15281,15520,13133,13998,6466,6118,6333,6236,8671,8386,7933,7850,12118,12116,11839,11552,9933,9493,9632,9578,-3.2,-2.7,1.9,-3.4,-3.2,1784,1976,1537,1107,2185,2623,2207,1974,화승코퍼레이션,013520,1027
8792,12016,11158,11386,3593,4846,6330,6976,4080,5196,5605,6954,7605,9789,11550,13303,4773,6114,6175,7798,7.8,2.5,7.5,3.9,-0.6,913,1504,1888,1792,2832,3675,5375,5505,화승엔터프라이즈,241590,1027
11119,14259,12988,13655,4672,6366,7646,8203,5420,6845,7133,8547,9913,12707,14335,16371,6371,8173,8062,10024,5.8,2.8,7.2,3.7,-0.3,1928,2476,2878,2768,3542,4534,6273,6347,화승인더,006060,1027
10758,11643,10855,12366,4120,3702,4089,4292,4668,3831,4482,4630,8282,8084,8227,8708,5350,5087,5670,5823,-3.4,-6.8,0.8,-6.7,2.9,2882,2936,2411,2674,2932,2997,2557,2885,화신,010690,1027
2156,2065,1617,2040,1816,1682,1382,1589,592,459,464,650,3856,3749,3784,4254,976,783,822,1171,2.5,3.4,2.0,1.2,2.3,1972,2020,2115,2188,2880,2966,2962,3083,화천기공,000850,1027
1547,1592,1717,1778,1878,2050,2144,2424,237,247,267,309,2877,3049,3296,3532,281,304,330,360,10.5,7.7,6.3,7.3,7.8,2400,2541,2732,2954,2596,2745,2966,3172,환인제약,016580,1027
2448,2436,2395,2710,1721,1795,2400,2052,1237,585,1216,714,4062,3902,4523,4316,1379,1073,1502,991,6.2,4.5,5.9,4.7,7.5,2122,2283,2439,2718,2683,2829,3021,3325,황금에스티,032560,1027
30025,31756,25962,35389,13794,13120,16268,19065,22479,22384,10903,15612,64079,65271,44298,52579,37058,38168,19154,22656,2.4,32.7,2.3,0.0,11.2,63534,63366,61805,64983,27021,27103,25144,29923,효성,004800,1021
4021,3882,4841,4759,625,599,557,658,652,815,889,1068,1214,1593,1617,2414,736,1076,1123,1381,7.1,5.6,7.7,7.9,7.1,256,266,253,285,478,517,494,1033,효성ITX,094280,1026
2749,2489,2616,3813,1219,1311,1329,1822,706,921,1460,1620,4415,5289,5401,6163,1960,2860,2949,3329,9.0,7.4,0.0,0.5,5.4,1019,1080,1170,1390,2455,2429,2452,2834,후성,093370,1027
29546,34504,31288,37940,13379,15868,16861,20411,6723,8674,9955,10514,33043,37702,37584,42889,17978,19693,19011,19824,3.4,6.6,9.6,5.3,8.4,8224,10800,11793,14060,15065,18009,18573,23065,휠라홀딩스,081660,1016
12625,10293,9203,10826,5166,2885,3979,3419,4522,3422,2980,3313,9581,8772,8729,8434,5500,4810,3971,3756,2.6,2.0,0.0,9.4,0.4,2103,1996,2762,2652,4081,3962,4758,4678,휴비스,079980,1027
5888,5370,3656,6165,3000,2650,2615,4119,1778,1462,1248,1756,6035,5791,6041,9519,1974,1825,1897,3255,0.6,2.7,-2.1,1.5,4.9,2366,2193,2278,2647,4061,3966,4144,6264,휴스틸,005010,1027
7629,6598,5935,8612,5296,4268,4345,5205,1007,1680,908,1832,8647,9139,8666,9493,1987,2422,1794,2297,13.5,12.0,7.9,5.6,8.5,4556,4779,4931,5286,6660,6717,6872,7196,TKG휴켐스,069260,1027
1008,1022,889,817,1084,938,591,553,3125,2023,1528,267,8037,4310,2868,2473,7306,4000,3131,1444,-6.8,-10.3,-8.3,-14.2,6.2,-398,-455,-964,-801,731,310,-263,1029,흥아해운,003280,1019
